,AVG_DREB_DIST,AVG_OREB_DIST,AVG_REB_DIST,DREB,DREB_CHANCES,DREB_CHANCE_DEFER,DREB_CHANCE_PCT,DREB_CHANCE_PCT_ADJ,DREB_CONTEST,DREB_CONTEST_PCT,DREB_UNCONTEST,GP,L,MIN,OREB,OREB_CHANCES,OREB_CHANCE_DEFER,OREB_CHANCE_PCT,OREB_CHANCE_PCT_ADJ,OREB_CONTEST,OREB_CONTEST_PCT,OREB_UNCONTEST,PLAYER_ID,PLAYER_NAME,REB,REB_CHANCES,REB_CHANCE_DEFER,REB_CHANCE_PCT,REB_CHANCE_PCT_ADJ,REB_CONTEST,REB_CONTEST_PCT,REB_UNCONTEST,TEAM_ABBREVIATION,TEAM_ID,W
0,3.9,10.0,5.4,15,27,5,0.556,0.682,5,0.333,10,17,14,77.0,5,18,2,0.278,0.313,2,0.4,3,1627773,AJ Hammons,20,45,7,0.444,0.526,7,0.35,13,DAL,1610612742,3
1,10.7,15.0,12.0,35,64,17,0.547,0.745,4,0.114,31,41,17,568.0,14,25,3,0.56,0.636,4,0.286,10,201166,Aaron Brooks,49,89,20,0.551,0.71,8,0.163,41,IND,1610612754,24
2,6.4,7.1,6.6,183,292,58,0.627,0.782,21,0.115,161,56,35,1548.0,74,128,10,0.578,0.627,50,0.676,23,203932,Aaron Gordon,257,420,68,0.612,0.73,71,0.276,184,ORL,1610612753,21
3,5.1,0.0,5.1,2,3,0,0.667,0.667,0,0.0,2,4,3,13.0,0,0,0,0.0,0.0,0,0.0,0,1626151,Aaron Harrison,2,3,0,0.667,0.667,0,0.0,2,CHA,1610612766,1
4,3.8,6.5,4.6,14,22,3,0.636,0.737,4,0.286,10,12,8,92.0,6,14,1,0.429,0.462,4,0.667,2,203940,Adreian Payne,20,36,4,0.556,0.625,8,0.4,12,MIN,1610612750,4
5,6.1,9.0,6.7,237,417,86,0.568,0.716,70,0.295,166,45,15,1480.0,60,111,11,0.541,0.6,33,0.55,27,201143,Al Horford,297,528,97,0.563,0.689,103,0.347,193,BOS,1610612738,30
6,4.1,5.5,4.4,155,272,63,0.57,0.742,45,0.29,110,52,25,747.0,56,115,6,0.487,0.514,41,0.732,15,2744,Al Jefferson,211,387,69,0.545,0.664,86,0.408,125,IND,1610612754,27
7,5.3,6.9,5.6,230,393,80,0.585,0.735,62,0.27,168,37,21,1075.0,43,100,10,0.43,0.478,30,0.698,13,202329,Al-Farouq Aminu,273,493,90,0.554,0.677,92,0.337,181,POR,1610612757,16
8,6.9,9.3,7.2,20,46,16,0.435,0.667,2,0.1,18,23,8,266.0,3,13,3,0.231,0.3,3,1.0,0,101187,Alan Anderson,23,59,19,0.39,0.575,5,0.217,18,LAC,1610612746,15
9,4.8,5.6,5.1,43,78,16,0.551,0.694,16,0.372,27,23,18,164.0,31,68,6,0.456,0.5,25,0.806,6,1626210,Alan Williams,74,146,22,0.507,0.597,41,0.554,33,PHX,1610612756,5
10,5.7,15.5,6.9,34,57,15,0.596,0.81,6,0.176,28,21,8,319.0,5,16,2,0.313,0.357,2,0.4,3,202692,Alec Burks,39,73,17,0.534,0.696,8,0.205,31,UTA,1610612762,13
11,9.0,12.8,9.9,37,69,22,0.536,0.787,9,0.243,27,45,21,624.0,11,19,2,0.579,0.647,5,0.455,6,203518,Alex Abrines,48,88,24,0.545,0.75,14,0.292,33,OKC,1610612760,24
12,4.1,4.1,4.1,229,363,81,0.631,0.812,54,0.236,174,51,37,1015.0,99,244,29,0.406,0.46,74,0.747,24,203458,Alex Len,328,607,110,0.54,0.66,128,0.39,198,PHX,1610612756,14
13,4.7,4.7,4.7,78,145,36,0.538,0.716,16,0.205,62,23,15,350.0,26,61,4,0.426,0.456,20,0.769,6,201582,Alexis Ajinca,104,206,40,0.505,0.627,36,0.346,68,NOP,1610612740,8
14,7.0,19.3,8.2,140,239,56,0.586,0.765,30,0.214,109,56,33,1595.0,14,37,4,0.378,0.424,7,0.5,7,203459,Allen Crabbe,154,276,60,0.558,0.713,37,0.24,116,POR,1610612757,23
15,6.0,4.7,5.6,10,22,9,0.455,0.769,3,0.3,7,13,9,89.0,4,9,0,0.444,0.444,2,0.5,2,202087,Alonzo Gee,14,31,9,0.452,0.636,5,0.357,9,DEN,1610612743,4
16,4.1,4.6,4.2,159,310,66,0.513,0.652,57,0.358,102,54,19,1049.0,86,209,13,0.411,0.439,63,0.733,23,101161,Amir Johnson,245,519,79,0.472,0.557,120,0.49,125,BOS,1610612738,35
17,5.3,3.4,4.4,14,29,8,0.483,0.667,5,0.357,9,13,2,87.0,12,26,3,0.462,0.522,9,0.75,3,2760,Anderson Varejao,26,55,11,0.473,0.591,14,0.538,12,GSW,1610612744,11
18,3.5,4.6,3.8,537,790,123,0.68,0.805,144,0.268,396,55,29,1680.0,229,422,25,0.543,0.577,182,0.795,47,203083,Andre Drummond,766,1212,148,0.632,0.72,326,0.426,443,DET,1610612765,26
19,9.1,10.6,9.3,170,255,37,0.667,0.78,34,0.2,138,53,7,1357.0,37,60,4,0.617,0.661,19,0.514,18,2738,Andre Iguodala,207,315,41,0.657,0.755,53,0.256,156,GSW,1610612744,46
20,5.8,6.6,6.0,225,395,103,0.57,0.771,45,0.2,178,56,24,1727.0,65,163,19,0.399,0.451,44,0.677,21,203460,Andre Roberson,290,558,122,0.52,0.665,89,0.307,199,OKC,1610612760,32
21,3.9,5.5,4.3,162,259,48,0.625,0.768,35,0.216,127,26,18,582.0,55,111,4,0.495,0.514,40,0.727,14,101106,Andrew Bogut,217,370,52,0.586,0.682,75,0.346,141,DAL,1610612742,8
22,9.7,18.4,11.3,83,163,45,0.509,0.703,11,0.133,72,52,21,1158.0,19,45,7,0.422,0.5,10,0.526,9,1626150,Andrew Harrison,102,208,52,0.49,0.654,21,0.206,81,MEM,1610612763,31
23,3.8,4.2,3.9,22,63,19,0.349,0.5,3,0.136,19,27,9,222.0,11,38,5,0.289,0.333,8,0.727,3,203094,Andrew Nicholson,33,101,24,0.327,0.429,11,0.333,22,WAS,1610612764,18
24,7.5,7.3,7.4,165,313,86,0.527,0.727,44,0.267,122,57,35,2120.0,71,172,33,0.413,0.511,51,0.718,21,203952,Andrew Wiggins,236,485,119,0.487,0.645,95,0.403,143,MIN,1610612750,22
25,4.2,4.6,4.3,45,73,14,0.616,0.763,13,0.289,32,19,16,209.0,21,32,3,0.656,0.724,19,0.905,2,203461,Anthony Bennett,66,105,17,0.629,0.75,32,0.485,34,BKN,1610612751,3
26,6.9,12.2,8.2,25,37,8,0.676,0.862,4,0.16,21,11,8,159.0,8,10,1,0.8,0.889,3,0.375,5,1626148,Anthony Brown,33,47,9,0.702,0.868,7,0.212,26,ORL,1610612753,3
27,4.5,5.2,4.7,505,753,129,0.671,0.809,121,0.24,388,52,31,1884.0,117,212,11,0.552,0.582,93,0.795,26,203076,Anthony Davis,622,965,140,0.645,0.754,214,0.344,414,NOP,1610612740,21
28,11.9,13.3,12.5,18,49,16,0.367,0.545,4,0.222,14,39,18,617.0,11,22,3,0.5,0.579,6,0.545,5,201627,Anthony Morrow,29,71,19,0.408,0.558,10,0.345,19,OKC,1610612760,21
29,5.9,7.9,6.4,125,221,49,0.566,0.727,17,0.136,105,45,25,1042.0,45,98,11,0.459,0.517,27,0.6,18,201229,Anthony Tolliver,170,319,60,0.533,0.656,44,0.259,123,SAC,1610612758,20
30,0.0,0.0,0.0,0,2,2,0.0,0.0,0,0.0,0,3,2,30.0,0,0,0,0.0,0.0,0,0.0,0,203462,Archie Goodwin,0,2,2,0.0,0.0,0,0.0,0,NOP,1610612740,1
31,2.3,2.2,2.3,4,6,0,0.667,0.667,1,0.25,3,8,5,28.0,2,2,0,1.0,1.0,2,1.0,0,202620,Arinze Onuaku,6,8,0,0.75,0.75,3,0.5,3,ORL,1610612753,3
32,4.5,3.2,4.1,149,286,74,0.521,0.703,32,0.215,117,53,27,817.0,64,200,24,0.32,0.364,49,0.766,15,203382,Aron Baynes,213,486,98,0.438,0.549,81,0.38,132,DET,1610612765,26
33,9.0,11.8,9.3,84,148,36,0.568,0.75,9,0.107,76,49,28,1253.0,9,26,2,0.346,0.375,5,0.556,4,201167,Arron Afflalo,93,174,38,0.534,0.684,14,0.151,80,SAC,1610612758,21
34,8.7,10.5,9.0,96,202,54,0.475,0.649,6,0.063,89,53,21,1505.0,16,58,10,0.276,0.333,7,0.438,9,203085,Austin Rivers,112,260,64,0.431,0.571,13,0.116,98,LAC,1610612746,32
35,4.9,8.8,5.5,196,319,63,0.614,0.766,37,0.189,159,34,13,1180.0,37,78,3,0.474,0.493,20,0.541,17,202340,Avery Bradley,233,397,66,0.587,0.704,57,0.245,176,BOS,1610612738,21
36,6.1,8.9,6.7,50,105,36,0.476,0.725,8,0.16,42,42,22,754.0,13,35,5,0.371,0.433,6,0.462,7,203463,Ben McLemore,63,140,41,0.45,0.636,14,0.222,49,SAC,1610612758,20
37,9.4,22.8,10.8,33,60,17,0.55,0.767,5,0.152,28,29,14,403.0,4,11,0,0.364,0.364,1,0.25,3,2757,Beno Udrih,37,71,17,0.521,0.685,6,0.162,31,DET,1610612765,15
38,4.2,5.8,4.7,302,498,102,0.606,0.763,64,0.212,239,57,36,1327.0,112,249,24,0.45,0.498,78,0.696,37,202687,Bismack Biyombo,414,747,126,0.554,0.667,142,0.343,276,ORL,1610612753,21
39,5.1,6.0,5.3,230,354,72,0.65,0.816,53,0.23,178,35,12,1162.0,76,157,22,0.484,0.563,50,0.658,25,201933,Blake Griffin,306,511,94,0.599,0.734,103,0.337,203,LAC,1610612746,23
40,4.6,3.9,4.3,45,59,7,0.763,0.865,13,0.289,32,23,11,159.0,30,50,3,0.6,0.638,24,0.8,6,1626246,Boban Marjanovic,75,109,10,0.688,0.758,37,0.493,38,DET,1610612765,12
41,10.6,0.0,10.6,5,8,2,0.625,0.833,1,0.2,4,16,4,48.0,0,0,0,0.0,0.0,0,0.0,0,201628,Bobby Brown,5,8,2,0.625,0.833,1,0.2,4,HOU,1610612745,12
42,4.8,6.8,5.4,82,151,31,0.543,0.683,17,0.207,64,36,20,439.0,35,93,8,0.376,0.412,26,0.743,9,1626171,Bobby Portis,117,244,39,0.48,0.571,43,0.368,73,CHI,1610612741,16
43,6.1,11.0,6.6,161,238,37,0.676,0.801,19,0.118,142,50,42,1346.0,17,46,3,0.37,0.395,11,0.647,6,202711,Bojan Bogdanovic,178,284,40,0.627,0.73,30,0.169,148,BKN,1610612751,8
44,6.2,7.6,6.5,71,155,45,0.458,0.645,18,0.254,53,48,19,872.0,26,74,5,0.351,0.377,18,0.692,8,2564,Boris Diaw,97,229,50,0.424,0.542,36,0.371,61,UTA,1610612762,29
45,9.5,14.6,10.6,117,215,51,0.544,0.713,22,0.188,94,50,17,1718.0,31,83,11,0.373,0.431,11,0.355,19,203078,Bradley Beal,148,298,62,0.497,0.627,33,0.223,113,WAS,1610612764,33
46,5.3,8.8,7.1,10,17,3,0.588,0.714,1,0.1,9,8,2,111.0,10,22,4,0.455,0.556,4,0.4,6,201148,Brandan Wright,20,39,7,0.513,0.625,5,0.25,15,MEM,1610612763,6
47,5.4,6.6,5.8,59,102,20,0.578,0.72,12,0.203,46,37,16,436.0,26,57,4,0.456,0.491,16,0.615,11,101138,Brandon Bass,85,159,24,0.535,0.63,28,0.329,57,LAC,1610612746,21
48,6.5,8.7,6.9,194,332,84,0.584,0.782,37,0.191,158,58,39,1604.0,41,102,8,0.402,0.436,22,0.537,19,1627742,Brandon Ingram,235,434,92,0.541,0.687,59,0.251,177,LAL,1610612747,19
49,9.4,12.1,9.8,128,227,59,0.564,0.762,18,0.141,109,56,33,1402.0,20,65,10,0.308,0.364,6,0.3,14,201943,Brandon Jennings,148,292,69,0.507,0.664,24,0.162,123,NYK,1610612752,23
50,7.6,11.1,8.3,93,191,56,0.487,0.689,17,0.183,78,52,37,1098.0,25,62,10,0.403,0.481,11,0.44,13,202688,Brandon Knight,118,253,66,0.466,0.631,28,0.237,91,PHX,1610612756,15
51,8.1,12.9,9.1,32,77,36,0.416,0.78,4,0.125,28,23,16,414.0,8,16,3,0.5,0.615,3,0.375,5,201575,Brandon Rush,40,93,39,0.43,0.741,7,0.175,33,MIN,1610612750,7
52,8.3,6.9,8.0,12,20,7,0.6,0.923,0,0.0,12,19,12,142.0,3,3,0,1.0,1.0,2,0.667,1,203148,Brian Roberts,15,23,7,0.652,0.938,2,0.133,13,CHA,1610612766,7
53,3.7,0.0,3.7,3,4,1,0.75,1.0,0,0.0,3,5,1,41.0,0,2,0,0.0,0.0,0,0.0,0,1627362,Briante Weber,3,6,1,0.5,0.6,0,0.0,3,GSW,1610612744,4
54,6.6,5.8,6.4,171,323,73,0.529,0.684,57,0.333,116,48,40,1430.0,76,155,9,0.49,0.521,57,0.75,18,201572,Brook Lopez,247,478,82,0.517,0.624,114,0.462,134,BKN,1610612751,8
55,4.5,3.7,4.2,3,6,3,0.5,1.0,1,0.333,2,7,1,21.0,2,4,0,0.5,0.5,1,0.5,1,203998,Bruno Caboclo,5,10,3,0.5,0.714,2,0.4,3,TOR,1610612761,6
56,10.8,20.4,12.2,6,10,2,0.6,0.75,2,0.333,4,18,4,86.0,1,1,0,1.0,1.0,0,0.0,1,1627854,Bryn Forbes,7,11,2,0.636,0.778,2,0.286,5,SAS,1610612759,14
57,7.7,10.6,8.0,143,243,66,0.588,0.808,18,0.126,125,56,33,1138.0,19,54,7,0.352,0.404,9,0.474,10,1627741,Buddy Hield,162,297,73,0.545,0.723,27,0.167,135,NOP,1610612740,23
58,9.2,14.5,10.4,160,298,70,0.537,0.702,30,0.188,132,56,33,1934.0,47,99,15,0.475,0.56,15,0.319,32,203468,CJ McCollum,207,397,85,0.521,0.663,45,0.217,164,POR,1610612757,23
59,7.4,11.2,7.8,118,185,28,0.638,0.752,29,0.246,89,46,22,1054.0,12,28,5,0.429,0.522,5,0.417,7,101139,CJ Miles,130,213,33,0.61,0.722,34,0.262,96,IND,1610612754,24
60,8.8,17.0,10.0,58,115,36,0.504,0.734,9,0.155,48,46,31,774.0,10,28,5,0.357,0.435,5,0.5,5,201228,CJ Watson,68,143,41,0.476,0.667,14,0.206,53,ORL,1610612753,15
61,8.0,16.5,9.9,7,14,4,0.5,0.7,0,0.0,7,16,10,75.0,2,6,1,0.333,0.4,0,0.0,2,203912,CJ Wilcox,9,20,5,0.45,0.6,0,0.0,9,ORL,1610612753,6
62,8.5,11.1,8.6,29,41,6,0.707,0.829,2,0.069,27,20,9,320.0,2,8,0,0.25,0.25,0,0.0,2,1626166,Cameron Payne,31,49,6,0.633,0.721,2,0.065,29,OKC,1610612760,11
63,6.9,14.5,7.9,78,125,19,0.624,0.736,8,0.103,70,31,27,624.0,11,27,1,0.407,0.423,6,0.545,5,1627747,Caris LeVert,89,152,20,0.586,0.674,14,0.157,75,BKN,1610612751,4
64,5.8,8.0,6.1,291,428,64,0.68,0.799,57,0.196,234,56,33,1906.0,48,97,13,0.495,0.571,38,0.792,10,2546,Carmelo Anthony,339,525,77,0.646,0.757,95,0.28,244,NYK,1610612752,23
65,8.3,4.6,8.1,62,100,24,0.62,0.816,9,0.145,53,27,11,523.0,3,12,4,0.25,0.375,3,1.0,0,202718,Chandler Parsons,65,112,28,0.58,0.774,12,0.185,53,MEM,1610612763,16
66,4.9,7.5,5.3,149,272,60,0.548,0.703,42,0.282,107,46,15,857.0,28,59,7,0.475,0.538,19,0.679,9,101112,Channing Frye,177,331,67,0.535,0.67,61,0.345,116,CLE,1610612739,31
67,10.6,0.0,10.6,5,13,1,0.385,0.417,2,0.4,3,8,7,74.0,0,0,0,0.0,0.0,0,0.0,0,1626184,Chasson Randle,5,13,1,0.385,0.417,2,0.4,3,PHI,1610612755,1
68,6.3,7.1,6.6,20,32,7,0.625,0.8,0,0.0,20,9,5,94.0,12,31,1,0.387,0.4,6,0.5,6,1627767,Cheick Diallo,32,63,8,0.508,0.582,6,0.188,26,NOP,1610612740,4
69,5.7,2.6,4.7,2,3,1,0.667,1.0,1,0.5,1,2,1,10.0,1,5,1,0.2,0.25,1,1.0,0,1627778,Chinanu Onuaku,3,8,2,0.375,0.5,2,0.667,1,HOU,1610612745,1
70,3.7,5.2,4.1,22,50,6,0.44,0.5,3,0.136,19,12,4,114.0,9,26,2,0.346,0.375,8,0.889,1,2365,Chris Andersen,31,76,8,0.408,0.456,11,0.355,20,CLE,1610612739,8
71,2.9,11.7,7.6,6,14,4,0.429,0.6,0,0.0,7,13,13,62.0,8,13,2,0.615,0.727,4,0.5,4,1626191,Chris McCullough,14,27,6,0.519,0.667,4,0.286,11,BKN,1610612751,0
72,7.2,13.7,8.1,162,283,66,0.572,0.747,18,0.111,144,35,9,1079.0,24,42,4,0.571,0.632,11,0.458,15,101108,Chris Paul,186,325,70,0.572,0.729,29,0.156,159,LAC,1610612746,26
73,3.9,0.0,3.9,4,6,1,0.667,0.8,1,0.25,3,2,2,13.0,0,0,0,0.0,0.0,0,0.0,0,1626174,Christian Wood,4,6,1,0.667,0.8,1,0.25,3,CHA,1610612766,0
74,4.4,5.3,4.7,211,360,72,0.586,0.733,60,0.284,151,42,13,979.0,100,230,14,0.435,0.463,71,0.71,29,203991,Clint Capela,311,590,86,0.527,0.617,131,0.421,180,HOU,1610612745,29
75,5.7,4.7,5.3,154,307,84,0.502,0.691,41,0.266,113,37,17,1000.0,88,207,24,0.425,0.481,62,0.705,26,203469,Cody Zeller,242,514,108,0.471,0.596,103,0.426,139,CHA,1610612766,20
76,5.1,6.2,5.5,97,167,37,0.581,0.746,29,0.299,68,51,32,472.0,47,109,12,0.431,0.485,30,0.638,17,202332,Cole Aldrich,144,276,49,0.522,0.634,59,0.41,85,MIN,1610612750,19
77,7.7,13.1,8.7,93,157,34,0.592,0.756,12,0.129,82,57,17,908.0,21,54,10,0.389,0.477,5,0.238,15,201147,Corey Brewer,114,211,44,0.54,0.683,17,0.149,97,HOU,1610612745,40
78,7.2,9.7,7.7,108,235,72,0.46,0.663,25,0.231,83,53,24,1200.0,29,77,9,0.377,0.426,16,0.552,12,202709,Cory Joseph,137,312,81,0.439,0.593,41,0.299,95,TOR,1610612761,29
79,9.6,12.8,10.3,129,223,55,0.578,0.768,20,0.155,110,52,31,1630.0,38,73,6,0.521,0.567,19,0.5,20,201584,Courtney Lee,167,296,61,0.564,0.711,39,0.234,130,NYK,1610612752,21
80,4.1,4.0,4.1,127,252,79,0.504,0.734,35,0.276,92,45,23,707.0,95,223,16,0.426,0.459,75,0.789,20,1626245,Cristiano Felicio,222,475,95,0.467,0.584,110,0.495,112,CHI,1610612741,22
81,8.3,12.4,8.9,135,232,50,0.582,0.742,18,0.133,117,42,26,1112.0,23,61,5,0.377,0.411,13,0.565,11,1626156,D'Angelo Russell,158,293,55,0.539,0.664,31,0.196,128,LAL,1610612747,16
82,10.8,17.3,11.5,76,110,14,0.691,0.792,7,0.092,70,57,36,1177.0,9,29,4,0.31,0.36,2,0.222,7,201571,D.J. Augustin,85,139,18,0.612,0.702,9,0.106,77,ORL,1610612753,21
83,6.3,6.5,6.4,5,9,1,0.556,0.625,0,0.0,5,8,2,45.0,6,14,0,0.429,0.429,3,0.5,3,1627745,Damian Jones,11,23,1,0.478,0.5,3,0.273,8,GSW,1610612744,6
84,8.3,10.9,8.7,215,380,95,0.566,0.754,28,0.13,187,51,30,1832.0,35,95,12,0.368,0.422,19,0.543,16,203081,Damian Lillard,250,475,107,0.526,0.679,47,0.188,203,POR,1610612757,21
85,7.8,14.1,9.1,18,37,11,0.486,0.692,2,0.111,16,35,25,267.0,5,11,0,0.455,0.455,2,0.4,3,204014,Damjan Rudez,23,48,11,0.479,0.622,4,0.174,19,ORL,1610612753,10
86,4.6,3.1,4.4,13,22,4,0.591,0.722,2,0.154,11,13,4,47.0,2,11,0,0.182,0.182,1,0.5,1,1627849,Daniel Ochefu,15,33,4,0.455,0.517,3,0.2,12,WAS,1610612764,9
87,7.3,11.5,7.8,191,301,74,0.635,0.841,36,0.188,154,43,24,1474.0,24,70,14,0.343,0.429,11,0.458,13,201568,Danilo Gallinari,215,371,88,0.58,0.76,47,0.219,167,DEN,1610612743,19
88,5.9,12.6,6.6,139,271,73,0.513,0.702,26,0.187,111,47,10,1253.0,17,52,8,0.327,0.386,10,0.588,7,201980,Danny Green,156,323,81,0.483,0.645,36,0.231,118,SAS,1610612759,37
89,5.3,7.2,5.7,141,249,61,0.566,0.75,22,0.156,119,42,24,1056.0,34,89,12,0.382,0.442,23,0.676,12,201967,Dante Cunningham,175,338,73,0.518,0.66,45,0.257,131,NOP,1610612740,18
90,7.9,15.2,9.4,55,107,23,0.514,0.655,8,0.145,47,41,16,751.0,14,23,1,0.609,0.636,4,0.286,10,203957,Dante Exum,69,130,24,0.531,0.651,12,0.174,57,UTA,1610612762,25
91,5.0,0.0,5.0,1,1,0,1.0,1.0,0,0.0,1,1,1,1.0,0,0,0,0.0,0.0,0,0.0,0,1627863,Danuel House,1,1,0,1.0,1.0,0,0.0,1,WAS,1610612764,0
92,4.8,6.4,5.2,239,444,121,0.538,0.74,71,0.297,170,54,33,1317.0,73,192,28,0.38,0.445,51,0.699,24,203967,Dario Saric,312,636,149,0.491,0.641,122,0.391,194,PHI,1610612755,21
93,6.9,8.5,7.3,61,121,40,0.504,0.753,12,0.197,49,29,17,473.0,21,50,7,0.42,0.488,15,0.714,6,201589,Darrell Arthur,82,171,47,0.48,0.661,27,0.329,55,DEN,1610612743,12
94,11.9,16.6,12.8,84,133,30,0.632,0.816,11,0.131,74,49,28,1516.0,19,57,6,0.333,0.373,9,0.474,11,201954,Darren Collison,103,190,36,0.542,0.669,20,0.194,85,SAC,1610612758,21
95,7.0,13.3,7.5,25,42,11,0.595,0.806,2,0.08,23,27,13,290.0,2,9,2,0.222,0.286,1,0.5,1,1626199,Darrun Hilliard,27,51,13,0.529,0.711,3,0.111,24,DET,1610612765,14
96,4.8,5.8,5.1,207,359,85,0.577,0.755,42,0.203,165,53,12,996.0,97,207,14,0.469,0.503,73,0.753,22,101135,David Lee,304,566,99,0.537,0.651,115,0.378,187,SAS,1610612759,41
97,4.6,4.4,4.6,86,155,34,0.555,0.711,27,0.314,59,41,6,478.0,26,49,4,0.531,0.578,19,0.731,7,2561,David West,112,204,38,0.549,0.675,46,0.411,66,GSW,1610612744,35
98,6.2,8.9,6.8,49,104,25,0.471,0.62,18,0.367,32,46,8,535.0,14,25,1,0.56,0.583,6,0.429,8,202722,Davis Bertans,63,129,26,0.488,0.612,24,0.381,40,SAS,1610612759,38
99,4.4,4.5,4.4,558,745,90,0.749,0.852,151,0.271,407,55,21,1715.0,191,331,23,0.577,0.62,156,0.817,34,201599,DeAndre Jordan,749,1076,113,0.696,0.778,307,0.41,441,LAC,1610612746,34
100,7.8,13.6,8.7,62,104,22,0.596,0.756,12,0.194,50,44,13,644.0,12,31,3,0.387,0.429,4,0.333,8,202732,DeAndre Liggins,74,135,25,0.548,0.673,16,0.216,58,CLE,1610612739,31
101,7.8,6.9,7.6,33,70,27,0.471,0.767,6,0.182,27,25,13,267.0,8,19,0,0.421,0.421,5,0.625,3,1627761,DeAndre' Bembry,41,89,27,0.461,0.661,11,0.268,30,ATL,1610612737,12
102,7.6,11.8,8.4,211,327,56,0.645,0.779,49,0.232,162,48,20,1709.0,48,115,11,0.417,0.462,27,0.563,21,201942,DeMar DeRozan,259,442,67,0.586,0.691,76,0.293,183,TOR,1610612761,28
103,4.3,5.5,4.6,469,686,99,0.684,0.799,101,0.215,370,55,32,1891.0,115,217,16,0.53,0.572,78,0.678,35,202326,DeMarcus Cousins,584,903,115,0.647,0.741,179,0.307,405,SAC,1610612758,23
104,6.0,7.3,6.3,160,305,78,0.525,0.705,31,0.194,129,50,22,1374.0,46,153,29,0.301,0.371,27,0.587,20,201960,DeMarre Carroll,206,458,107,0.45,0.587,58,0.282,149,TOR,1610612761,28
105,5.6,15.0,7.1,26,65,26,0.4,0.667,8,0.308,18,30,7,240.0,5,14,3,0.357,0.455,2,0.4,3,1627749,Dejounte Murray,31,79,29,0.392,0.62,10,0.323,21,SAS,1610612759,23
106,8.2,4.0,6.1,1,3,2,0.333,1.0,0,0.0,1,2,1,37.0,1,3,0,0.333,0.333,1,1.0,0,1626153,Delon Wright,2,6,2,0.333,0.5,1,0.5,1,TOR,1610612761,1
107,13.6,9.4,11.5,2,4,1,0.5,0.667,0,0.0,2,4,3,17.0,2,2,0,1.0,1.0,0,0.0,2,1627743,Demetrius Jackson,4,6,1,0.667,0.8,0,0.0,4,BOS,1610612738,1
108,9.6,14.0,10.4,131,245,73,0.535,0.762,24,0.183,109,55,24,1696.0,28,78,6,0.359,0.389,15,0.536,13,203471,Dennis Schroder,159,323,79,0.492,0.652,39,0.245,122,ATL,1610612737,31
109,7.6,18.8,8.0,49,97,25,0.505,0.681,11,0.224,38,29,15,379.0,2,7,0,0.286,0.286,0,0.0,2,1627756,Denzel Valentine,51,104,25,0.49,0.646,11,0.216,40,CHI,1610612741,14
110,9.3,20.1,10.6,88,153,44,0.575,0.807,11,0.125,77,39,25,1139.0,12,22,3,0.545,0.632,4,0.333,8,101114,Deron Williams,100,175,47,0.571,0.781,15,0.15,85,DAL,1610612742,14
111,4.5,5.4,4.8,170,293,69,0.58,0.759,42,0.247,127,39,13,911.0,66,145,14,0.455,0.504,50,0.758,17,202324,Derrick Favors,236,438,83,0.539,0.665,92,0.39,144,UTA,1610612762,26
112,0.6,1.8,1.3,1,2,1,0.5,1.0,1,1.0,0,7,6,24.0,2,2,0,1.0,1.0,1,0.5,1,1627884,"Derrick Jones, Jr.",3,4,1,0.75,1.0,2,0.667,1,PHX,1610612756,1
113,10.5,10.3,10.5,134,211,46,0.635,0.812,13,0.097,121,48,27,1544.0,55,128,31,0.43,0.567,33,0.6,22,201565,Derrick Rose,189,339,77,0.558,0.721,46,0.243,143,NYK,1610612752,21
114,5.0,5.6,5.1,69,117,29,0.59,0.784,13,0.188,56,29,21,469.0,16,27,1,0.593,0.615,13,0.813,3,202682,Derrick Williams,85,144,30,0.59,0.746,26,0.306,59,CLE,1610612739,8
115,8.9,10.8,9.3,117,211,58,0.555,0.765,12,0.103,105,53,37,1817.0,33,85,13,0.388,0.458,15,0.455,18,1626164,Devin Booker,150,296,71,0.507,0.667,27,0.18,123,PHX,1610612756,16
116,6.7,9.7,7.0,69,117,27,0.59,0.767,8,0.116,61,38,21,636.0,9,17,1,0.529,0.563,5,0.556,4,2734,Devin Harris,78,134,28,0.582,0.736,13,0.167,65,DAL,1610612742,17
117,4.2,5.6,4.5,237,325,42,0.729,0.837,67,0.283,168,48,12,838.0,79,157,15,0.503,0.556,55,0.696,24,203473,Dewayne Dedmon,316,482,57,0.656,0.744,122,0.386,192,SAS,1610612759,36
118,6.0,4.0,5.3,34,60,13,0.567,0.723,12,0.353,22,24,7,183.0,17,40,2,0.425,0.447,14,0.824,3,1627738,Deyonta Davis,51,100,15,0.51,0.6,26,0.51,25,MEM,1610612763,17
119,5.7,1.6,5.0,5,8,1,0.625,0.714,0,0.0,5,7,1,24.0,1,8,1,0.125,0.143,1,1.0,0,1627754,Diamond Stone,6,16,2,0.375,0.429,1,0.167,5,LAC,1610612746,6
120,8.4,12.7,8.9,106,192,50,0.552,0.746,18,0.17,88,34,16,1049.0,14,43,9,0.326,0.412,4,0.286,10,203079,Dion Waiters,120,235,59,0.511,0.682,22,0.183,98,MIA,1610612748,18
121,4.4,7.9,4.7,160,258,48,0.62,0.762,41,0.256,119,29,17,750.0,14,25,1,0.56,0.583,6,0.429,8,1717,Dirk Nowitzki,174,283,49,0.615,0.744,47,0.27,127,DAL,1610612742,12
122,5.0,6.9,5.3,175,310,82,0.565,0.768,52,0.297,122,56,24,1208.0,33,116,14,0.284,0.324,21,0.636,12,1627734,Domantas Sabonis,208,426,96,0.488,0.63,73,0.351,134,OKC,1610612760,32
123,4.3,6.7,5.0,52,86,19,0.605,0.776,21,0.404,31,20,11,318.0,17,44,4,0.386,0.425,13,0.765,5,202700,Donatas Motiejunas,69,130,23,0.531,0.645,34,0.493,36,NOP,1610612740,9
124,6.2,11.0,7.3,111,209,55,0.531,0.721,25,0.225,85,54,33,1134.0,32,99,17,0.323,0.39,20,0.625,13,1627827,Dorian Finney-Smith,143,308,72,0.464,0.606,45,0.315,98,DAL,1610612742,21
125,5.3,11.8,6.0,109,187,56,0.583,0.832,27,0.248,82,42,21,1033.0,14,42,5,0.333,0.378,9,0.643,5,203926,Doug McDermott,123,229,61,0.537,0.732,36,0.293,87,CHI,1610612741,21
126,5.7,9.3,6.4,60,99,16,0.606,0.723,8,0.133,52,36,26,453.0,15,23,0,0.652,0.652,10,0.667,6,1627733,Dragan Bender,75,122,16,0.615,0.708,18,0.24,58,PHX,1610612756,10
127,4.6,5.1,4.7,356,559,98,0.637,0.772,90,0.253,266,52,9,1715.0,68,111,13,0.613,0.694,52,0.765,16,203110,Draymond Green,424,670,111,0.633,0.758,142,0.335,282,GSW,1610612744,43
128,3.8,3.6,3.7,436,642,98,0.679,0.801,105,0.241,331,50,23,1475.0,210,368,27,0.571,0.616,159,0.757,51,2730,Dwight Howard,646,1010,125,0.64,0.73,264,0.409,382,ATL,1610612737,27
129,4.6,5.5,4.9,162,280,60,0.579,0.736,29,0.179,134,55,34,1010.0,74,188,14,0.394,0.425,50,0.676,26,203939,Dwight Powell,236,468,74,0.504,0.599,79,0.335,160,DAL,1610612742,21
130,6.4,8.4,6.9,159,250,48,0.636,0.787,22,0.138,138,45,23,1372.0,52,100,15,0.52,0.612,31,0.596,22,2548,Dwyane Wade,211,350,63,0.603,0.735,53,0.251,160,CHI,1610612741,22
131,9.0,13.1,10.0,84,166,43,0.506,0.683,16,0.19,68,50,29,1223.0,26,57,6,0.456,0.51,13,0.5,14,202734,E'Twaun Moore,110,223,49,0.493,0.632,29,0.264,82,NOP,1610612740,21
132,4.9,4.6,4.8,144,283,79,0.509,0.706,47,0.326,97,45,27,776.0,94,230,24,0.409,0.456,70,0.745,24,202334,Ed Davis,238,513,103,0.464,0.58,117,0.492,121,POR,1610612757,18
133,4.0,0.0,4.0,1,2,0,0.5,0.5,1,1.0,0,1,0,4.0,0,1,0,0.0,0.0,0,0.0,0,204002,Edy Tavares,1,3,0,0.333,0.333,1,1.0,0,ATL,1610612737,1
134,9.3,9.5,9.3,174,283,69,0.615,0.813,19,0.109,155,58,37,1690.0,46,118,14,0.39,0.442,29,0.63,18,203901,Elfrid Payton,220,401,83,0.549,0.692,48,0.218,173,ORL,1610612753,21
135,8.3,11.9,8.9,127,214,49,0.593,0.77,18,0.142,110,43,25,1215.0,26,69,14,0.377,0.473,11,0.423,15,1626144,Emmanuel Mudiay,153,283,63,0.541,0.695,29,0.19,125,DEN,1610612743,18
136,4.1,3.9,4.0,193,366,86,0.527,0.689,51,0.264,142,46,18,1011.0,122,300,40,0.407,0.469,101,0.828,22,202683,Enes Kanter,315,666,126,0.473,0.583,152,0.483,164,OKC,1610612760,28
137,7.9,11.7,8.6,213,359,89,0.593,0.789,29,0.136,185,53,37,1759.0,45,102,18,0.441,0.536,29,0.644,16,202339,Eric Bledsoe,258,461,107,0.56,0.729,58,0.225,201,PHX,1610612756,16
138,9.6,18.7,10.7,120,183,34,0.656,0.805,14,0.117,108,51,15,1555.0,17,40,6,0.425,0.5,8,0.471,9,201569,Eric Gordon,137,223,40,0.614,0.749,22,0.161,117,HOU,1610612745,36
139,5.3,6.0,5.5,253,414,80,0.611,0.757,66,0.261,188,54,30,1460.0,71,198,26,0.359,0.413,56,0.789,16,101141,Ersan Ilyasova,324,612,106,0.529,0.64,122,0.377,204,PHI,1610612755,24
140,8.1,12.7,9.1,116,219,59,0.53,0.725,19,0.164,97,45,29,1488.0,31,65,5,0.477,0.517,17,0.548,14,203095,Evan Fournier,147,284,64,0.518,0.668,36,0.245,111,ORL,1610612753,16
141,6.5,9.4,6.9,164,293,82,0.56,0.777,31,0.189,133,50,27,1311.0,27,54,2,0.5,0.519,14,0.519,13,202323,Evan Turner,191,347,84,0.55,0.726,45,0.236,146,POR,1610612757,23
142,5.8,6.5,5.9,196,328,73,0.598,0.769,47,0.24,151,52,32,1303.0,44,106,11,0.415,0.463,22,0.5,22,1626163,Frank Kaminsky,240,434,84,0.553,0.686,69,0.288,173,CHA,1610612766,20
143,8.3,11.9,8.9,16,26,5,0.615,0.762,5,0.313,11,20,7,143.0,3,8,0,0.375,0.375,0,0.0,3,1627832,Fred VanVleet,19,34,5,0.559,0.655,5,0.263,14,TOR,1610612761,13
144,9.0,11.5,9.6,105,191,43,0.55,0.709,36,0.343,69,49,30,1301.0,27,66,6,0.409,0.45,16,0.593,11,202066,Garrett Temple,132,257,49,0.514,0.635,52,0.394,80,SAC,1610612758,19
145,7.7,9.5,8.3,68,113,26,0.602,0.782,8,0.118,61,31,17,883.0,27,61,12,0.443,0.551,19,0.704,9,203914,Gary Harris,95,174,38,0.546,0.699,27,0.284,70,DEN,1610612743,14
146,10.2,0.0,10.2,1,2,0,0.5,0.5,0,0.0,1,2,1,18.0,0,0,0,0.0,0.0,0,0.0,0,202390,Gary Neal,1,2,0,0.5,0.5,0,0.0,1,ATL,1610612737,1
147,7.9,9.5,8.2,91,173,51,0.526,0.746,19,0.209,72,31,8,982.0,17,39,2,0.436,0.459,9,0.529,8,201588,George Hill,108,212,53,0.509,0.679,28,0.259,80,UTA,1610612762,23
148,5.3,6.0,5.4,11,23,9,0.478,0.786,1,0.091,10,18,8,73.0,1,10,2,0.1,0.125,1,1.0,0,1627777,Georges Niang,12,33,11,0.364,0.545,2,0.167,10,IND,1610612754,10
149,7.8,6.5,7.5,4,7,2,0.571,0.8,1,0.25,3,4,3,18.0,1,1,0,1.0,1.0,0,0.0,1,1627834,Georgios Papagiannis,5,8,2,0.625,0.833,1,0.2,4,SAC,1610612758,1
150,7.3,12.3,8.4,50,86,16,0.581,0.714,7,0.14,43,34,9,387.0,14,28,3,0.5,0.56,7,0.5,7,101123,Gerald Green,64,114,19,0.561,0.674,14,0.219,50,BOS,1610612738,25
151,8.3,10.5,8.6,103,178,41,0.579,0.752,19,0.184,84,49,30,1172.0,19,39,4,0.487,0.543,14,0.737,5,201945,Gerald Henderson,122,217,45,0.562,0.709,33,0.27,89,PHI,1610612755,19
152,6.1,6.1,6.1,351,552,111,0.636,0.796,69,0.197,280,52,29,1844.0,99,175,19,0.566,0.635,81,0.818,18,203507,Giannis Antetokounmpo,450,727,130,0.619,0.754,150,0.333,298,MIL,1610612749,23
153,6.2,8.7,6.8,150,303,83,0.495,0.682,27,0.18,124,50,24,1144.0,43,107,7,0.402,0.43,19,0.442,24,203922,Glenn Robinson III,193,410,90,0.471,0.603,46,0.238,148,IND,1610612754,26
154,9.6,12.0,10.0,153,284,82,0.539,0.757,23,0.15,130,49,25,1680.0,37,100,16,0.37,0.44,13,0.351,24,201609,Goran Dragic,190,384,98,0.495,0.664,36,0.189,154,MIA,1610612748,24
155,7.1,12.5,7.7,250,386,88,0.648,0.839,41,0.164,209,50,18,1732.0,31,71,8,0.437,0.492,14,0.452,17,202330,Gordon Hayward,281,457,96,0.615,0.778,55,0.196,226,UTA,1610612762,32
156,4.8,5.9,5.1,320,564,131,0.567,0.739,64,0.2,258,57,35,1825.0,130,305,27,0.426,0.468,91,0.7,38,203476,Gorgui Dieng,450,869,158,0.518,0.633,155,0.344,296,MIN,1610612750,22
157,4.7,4.9,4.8,248,403,76,0.615,0.758,72,0.29,173,52,29,1133.0,99,190,11,0.521,0.553,77,0.778,21,202328,Greg Monroe,347,593,87,0.585,0.686,149,0.429,194,MIL,1610612749,23
158,6.5,0.0,6.5,1,3,2,0.333,1.0,0,0.0,1,2,1,32.0,0,2,0,0.0,0.0,0,0.0,0,202349,Greivis Vasquez,1,5,2,0.2,0.333,0,0.0,1,BKN,1610612751,1
159,6.4,8.8,7.0,220,398,98,0.553,0.733,50,0.227,171,55,34,1971.0,69,159,15,0.434,0.479,33,0.478,38,203084,Harrison Barnes,289,557,113,0.519,0.651,83,0.287,209,DAL,1610612742,21
160,3.6,3.7,3.7,547,808,132,0.677,0.809,160,0.293,387,52,29,1712.0,185,441,39,0.42,0.46,142,0.768,43,202355,Hassan Whiteside,732,1249,171,0.586,0.679,302,0.413,430,MIA,1610612748,23
161,4.5,7.8,5.0,10,19,5,0.526,0.714,3,0.3,7,14,8,56.0,2,4,0,0.5,0.5,1,0.5,1,1627740,Henry Ellenson,12,23,5,0.522,0.667,4,0.333,8,DET,1610612765,6
162,6.2,14.5,7.7,63,115,32,0.548,0.759,17,0.27,44,29,20,515.0,13,29,1,0.448,0.464,9,0.692,4,203138,Hollis Thompson,76,144,33,0.528,0.685,26,0.342,48,PHI,1610612755,9
163,8.8,10.7,9.1,58,115,24,0.504,0.637,5,0.086,53,50,8,707.0,12,29,1,0.414,0.429,6,0.5,6,203546,Ian Clark,70,144,25,0.486,0.588,11,0.157,59,GSW,1610612744,42
164,6.3,9.0,6.7,11,21,7,0.524,0.786,1,0.091,10,5,1,67.0,2,9,0,0.222,0.222,0,0.0,2,101133,Ian Mahinmi,13,30,7,0.433,0.565,1,0.077,12,WAS,1610612764,4
165,7.4,9.5,7.8,116,199,47,0.583,0.763,20,0.172,97,49,15,1245.0,28,66,5,0.424,0.459,14,0.5,14,202697,Iman Shumpert,144,265,52,0.543,0.676,34,0.236,111,CLE,1610612739,34
166,8.4,8.9,8.5,39,75,20,0.52,0.709,6,0.154,33,30,16,517.0,5,11,2,0.455,0.556,3,0.6,2,203477,Isaiah Canaan,44,86,22,0.512,0.688,9,0.205,35,CHI,1610612741,14
167,11.2,13.7,11.7,109,193,40,0.565,0.712,13,0.119,97,51,16,1760.0,28,91,11,0.308,0.35,12,0.429,16,202738,Isaiah Thomas,137,284,51,0.482,0.588,25,0.182,113,BOS,1610612738,35
168,8.3,8.1,8.2,94,173,47,0.543,0.746,15,0.16,78,44,38,975.0,13,42,7,0.31,0.371,8,0.615,5,1627785,Isaiah Whitehead,107,215,54,0.498,0.665,23,0.215,83,BKN,1610612751,6
169,8.2,19.0,9.1,135,307,113,0.44,0.696,24,0.178,110,55,28,1286.0,14,35,7,0.4,0.5,4,0.286,9,202397,Ish Smith,149,342,120,0.436,0.671,28,0.188,119,DET,1610612765,27
170,4.7,4.1,4.5,62,115,23,0.539,0.674,20,0.323,42,23,17,305.0,28,70,3,0.4,0.418,24,0.857,3,1627826,Ivica Zubac,90,185,26,0.486,0.566,44,0.489,45,LAL,1610612747,6
171,9.0,19.0,9.9,46,74,18,0.622,0.821,3,0.065,43,17,12,424.0,5,12,0,0.417,0.417,0,0.0,5,200826,J.J. Barea,51,86,18,0.593,0.75,3,0.059,48,DAL,1610612742,5
172,9.3,15.0,9.9,105,201,60,0.522,0.745,16,0.152,88,52,19,1470.0,11,24,1,0.458,0.478,3,0.273,8,200755,JJ Redick,116,225,61,0.516,0.707,19,0.164,96,LAC,1610612746,33
173,8.6,12.9,9.5,34,66,17,0.515,0.694,5,0.147,29,19,5,540.0,8,14,1,0.571,0.615,4,0.5,4,2747,JR Smith,42,80,18,0.525,0.677,9,0.214,33,CLE,1610612739,14
174,5.0,4.8,4.9,285,420,73,0.679,0.821,60,0.211,225,55,22,1582.0,124,238,14,0.521,0.554,89,0.718,35,203210,JaMychal Green,409,658,87,0.622,0.716,149,0.364,260,MEM,1610612763,33
175,4.5,4.3,4.4,100,188,48,0.532,0.714,31,0.31,68,50,9,482.0,54,117,8,0.462,0.495,38,0.704,16,201580,JaVale McGee,154,305,56,0.505,0.618,69,0.448,84,GSW,1610612744,41
176,6.2,6.8,6.4,224,363,79,0.617,0.789,48,0.214,176,49,29,1660.0,74,162,11,0.457,0.49,49,0.662,25,203953,Jabari Parker,298,525,90,0.568,0.685,97,0.326,201,MIL,1610612749,20
177,6.3,10.3,6.8,210,328,57,0.64,0.775,31,0.148,179,46,15,1514.0,30,77,9,0.39,0.441,17,0.567,13,203109,Jae Crowder,240,405,66,0.593,0.708,48,0.2,192,BOS,1610612738,31
178,5.2,4.7,5.0,113,250,76,0.452,0.649,30,0.265,83,36,26,828.0,61,187,18,0.326,0.361,46,0.754,16,1626143,Jahlil Okafor,174,437,94,0.398,0.507,76,0.437,99,PHI,1610612755,10
179,7.3,15.4,8.4,12,31,11,0.387,0.6,3,0.25,9,24,16,149.0,2,6,0,0.333,0.333,1,0.5,1,1627774,Jake Layman,14,37,11,0.378,0.538,4,0.286,10,POR,1610612757,8
180,4.2,4.5,4.3,43,102,37,0.422,0.662,9,0.209,34,30,10,322.0,39,85,8,0.459,0.506,34,0.872,5,1627751,Jakob Poeltl,82,187,45,0.439,0.577,43,0.524,39,TOR,1610612761,20
181,11.9,13.2,12.1,80,139,28,0.576,0.721,7,0.088,72,55,21,1480.0,13,34,5,0.382,0.448,7,0.538,6,2037,Jamal Crawford,93,173,33,0.538,0.664,14,0.151,78,LAC,1610612746,34
182,9.1,15.5,10.6,109,171,44,0.637,0.858,26,0.239,82,55,31,1105.0,32,72,5,0.444,0.478,14,0.438,18,1627750,Jamal Murray,141,243,49,0.58,0.727,40,0.284,100,DEN,1610612743,24
183,10.1,16.7,11.2,114,202,49,0.564,0.745,18,0.158,95,55,31,1450.0,22,52,6,0.423,0.478,11,0.5,11,2749,Jameer Nelson,136,254,55,0.535,0.683,29,0.213,106,DEN,1610612743,24
184,6.0,8.0,6.6,124,210,43,0.59,0.743,23,0.185,101,43,18,1082.0,51,128,15,0.398,0.451,36,0.706,15,203516,James Ennis III,175,338,58,0.518,0.625,59,0.337,116,MEM,1610612763,25
185,6.0,9.6,6.5,402,599,114,0.671,0.829,66,0.164,338,57,17,2086.0,68,128,15,0.531,0.602,41,0.603,26,201935,James Harden,470,727,129,0.646,0.786,107,0.228,364,HOU,1610612745,40
186,5.8,7.8,6.2,213,386,111,0.552,0.775,41,0.192,173,52,27,1381.0,45,97,9,0.464,0.511,26,0.578,19,201949,James Johnson,258,483,120,0.534,0.711,67,0.26,192,MIA,1610612748,25
187,7.4,14.8,8.0,19,50,13,0.38,0.514,2,0.105,18,34,12,239.0,2,10,2,0.2,0.25,1,0.5,1,2592,James Jones,21,60,15,0.35,0.467,3,0.143,19,CLE,1610612739,22
188,6.1,5.5,5.9,31,62,12,0.5,0.62,10,0.323,21,28,5,258.0,13,45,8,0.289,0.351,10,0.769,4,203949,James Michael McAdoo,44,107,20,0.411,0.506,20,0.455,25,GSW,1610612744,23
189,5.9,11.6,7.5,15,20,3,0.75,0.882,3,0.2,12,18,7,151.0,6,11,0,0.545,0.545,3,0.5,3,203923,James Young,21,31,3,0.677,0.75,6,0.286,15,BOS,1610612738,11
190,6.5,10.1,7.0,111,233,68,0.476,0.673,26,0.234,84,39,29,808.0,20,57,12,0.351,0.444,10,0.5,10,201162,Jared Dudley,131,290,80,0.452,0.624,36,0.275,94,PHX,1610612756,10
191,4.4,8.2,5.8,17,28,8,0.607,0.85,3,0.176,14,11,9,118.0,10,30,4,0.333,0.385,6,0.6,4,203096,Jared Sullinger,27,58,12,0.466,0.587,9,0.333,18,TOR,1610612761,2
192,5.1,4.2,4.9,115,185,41,0.622,0.799,25,0.217,89,39,16,525.0,36,94,14,0.383,0.45,27,0.75,9,1626185,Jarell Martin,151,279,55,0.541,0.674,52,0.344,98,MEM,1610612763,23
193,4.9,2.6,3.8,1,3,1,0.333,0.5,0,0.0,1,2,2,7.0,1,4,1,0.25,0.333,1,1.0,0,203950,Jarnell Stokes,2,7,2,0.286,0.4,1,0.5,1,DEN,1610612743,0
194,5.2,7.2,5.8,121,227,53,0.533,0.695,37,0.306,83,53,20,710.0,52,130,12,0.4,0.441,33,0.635,19,201160,Jason Smith,173,357,65,0.485,0.592,70,0.405,102,WAS,1610612764,33
195,11.9,17.9,12.9,44,78,15,0.564,0.698,7,0.159,38,46,27,786.0,10,13,0,0.769,0.769,2,0.2,8,1891,Jason Terry,54,91,15,0.593,0.711,9,0.167,46,MIL,1610612749,19
196,6.3,7.5,6.5,105,172,42,0.61,0.808,19,0.181,86,51,18,777.0,24,61,4,0.393,0.421,11,0.458,13,1627759,Jaylen Brown,129,233,46,0.554,0.69,30,0.233,99,BOS,1610612738,33
197,7.1,10.3,7.7,140,256,61,0.547,0.718,29,0.207,110,56,35,1301.0,32,68,8,0.471,0.533,16,0.5,15,201145,Jeff Green,172,324,69,0.531,0.675,45,0.262,125,ORL,1610612753,21
198,8.8,13.2,9.2,203,302,59,0.672,0.835,25,0.123,178,52,25,1713.0,23,71,5,0.324,0.348,10,0.435,13,201952,Jeff Teague,226,373,64,0.606,0.731,35,0.155,191,IND,1610612754,27
199,3.8,4.4,4.1,42,88,26,0.477,0.677,9,0.214,33,31,9,244.0,27,51,1,0.529,0.54,16,0.593,11,203481,Jeff Withey,69,139,27,0.496,0.616,25,0.362,44,UTA,1610612762,22
200,6.8,9.5,7.2,126,253,71,0.498,0.692,41,0.325,87,55,26,1164.0,25,68,15,0.368,0.472,10,0.4,14,203924,Jerami Grant,151,321,86,0.47,0.643,51,0.338,101,OKC,1610612760,29
201,4.9,7.7,5.2,140,200,29,0.7,0.819,20,0.143,119,36,21,617.0,17,40,7,0.425,0.515,11,0.647,7,203087,Jeremy Lamb,157,240,36,0.654,0.77,31,0.197,126,CHA,1610612766,15
202,6.1,25.2,6.7,29,49,11,0.592,0.763,3,0.103,26,8,6,203.0,1,8,0,0.125,0.125,0,0.0,1,202391,Jeremy Lin,30,57,11,0.526,0.652,3,0.1,27,BKN,1610612751,2
203,8.0,19.7,9.9,56,109,35,0.514,0.757,5,0.089,51,44,24,731.0,11,29,4,0.379,0.44,5,0.455,6,1626170,Jerian Grant,67,138,39,0.486,0.677,10,0.149,57,CHI,1610612741,20
204,7.6,21.9,11.1,9,16,4,0.563,0.75,1,0.111,8,3,2,71.0,3,6,1,0.5,0.6,2,0.667,1,201573,Jerryd Bayless,12,22,5,0.545,0.706,3,0.25,9,PHI,1610612755,1
205,7.4,10.6,8.2,220,387,90,0.568,0.741,44,0.2,178,48,22,1772.0,82,156,16,0.526,0.586,46,0.561,36,202710,Jimmy Butler,302,543,106,0.556,0.691,90,0.298,214,CHI,1610612741,26
206,3.8,4.5,4.1,241,389,60,0.62,0.733,60,0.249,179,46,29,1015.0,161,322,37,0.5,0.565,132,0.82,28,201149,Joakim Noah,402,711,97,0.565,0.655,192,0.478,207,NYK,1610612752,17
207,7.4,19.6,8.0,51,86,19,0.593,0.761,9,0.176,42,24,14,520.0,3,5,1,0.6,0.75,1,0.333,2,201975,Jodie Meeks,54,91,20,0.593,0.761,10,0.185,44,ORL,1610612753,10
208,7.3,8.6,7.4,108,204,53,0.529,0.715,15,0.139,93,43,35,944.0,14,61,10,0.23,0.275,8,0.571,6,203925,Joe Harris,122,265,63,0.46,0.604,23,0.189,99,BKN,1610612751,8
209,7.7,17.3,8.3,148,214,36,0.692,0.831,25,0.169,125,56,21,1232.0,11,23,3,0.478,0.55,4,0.364,7,204060,Joe Ingles,159,237,39,0.671,0.803,29,0.182,132,UTA,1610612762,35
210,7.2,10.8,7.7,146,216,40,0.676,0.83,28,0.192,117,55,21,1236.0,23,43,9,0.535,0.676,11,0.478,11,2207,Joe Johnson,169,259,49,0.653,0.805,39,0.231,128,UTA,1610612762,34
211,8.7,14.5,9.2,11,16,4,0.688,0.917,1,0.091,10,21,10,99.0,1,3,0,0.333,0.333,0,0.0,1,1626202,Joe Young,12,19,4,0.632,0.8,1,0.083,11,IND,1610612754,11
212,6.3,6.1,6.2,10,19,6,0.526,0.769,3,0.3,7,9,2,56.0,6,16,2,0.375,0.429,6,1.0,0,201202,Joel Anthony,16,35,8,0.457,0.593,9,0.563,7,SAS,1610612759,7
213,4.4,9.2,4.9,9,11,0,0.818,0.818,1,0.111,8,9,3,20.0,1,5,0,0.2,0.2,0,0.0,1,1627762,Joel Bolomboy,10,16,0,0.625,0.625,1,0.1,9,UTA,1610612762,6
214,3.7,5.6,4.2,178,315,73,0.565,0.736,60,0.337,117,30,17,761.0,59,120,9,0.492,0.532,45,0.763,14,203954,Joel Embiid,237,435,82,0.545,0.671,105,0.443,131,PHI,1610612755,13
215,4.4,5.9,4.8,129,208,46,0.62,0.796,36,0.279,94,49,19,720.0,47,93,9,0.505,0.56,32,0.681,15,203530,Joffrey Lauvergne,176,301,55,0.585,0.715,68,0.386,109,OKC,1610612760,30
216,4.9,5.4,5.1,163,273,48,0.597,0.724,51,0.313,112,45,26,909.0,62,165,12,0.376,0.405,49,0.79,13,203089,John Henson,225,438,60,0.514,0.595,100,0.444,125,MIL,1610612749,19
217,10.1,0.0,10.1,1,2,1,0.5,1.0,0,0.0,1,4,4,13.0,0,0,0,0.0,0.0,0,0.0,0,203098,John Jenkins,1,2,1,0.5,1.0,0,0.0,1,PHX,1610612756,0
218,0.0,0.0,0.0,0,0,0,0.0,0.0,0,0.0,0,5,2,11.0,0,0,0,0.0,0.0,0,0.0,0,101249,John Lucas III,0,0,0,0.0,0.0,0,0.0,0,MIN,1610612750,3
219,10.4,11.8,10.6,186,290,57,0.641,0.798,22,0.118,165,52,18,1902.0,42,86,15,0.488,0.592,20,0.476,22,202322,John Wall,228,376,72,0.606,0.75,42,0.184,187,WAS,1610612764,34
220,4.9,6.3,5.5,6,10,1,0.6,0.667,1,0.167,5,7,5,46.0,5,5,0,1.0,1.0,4,0.8,1,203948,Johnny O'Bryant III,11,15,1,0.733,0.786,5,0.455,6,DEN,1610612743,2
221,4.6,5.8,4.9,215,404,121,0.532,0.76,49,0.228,168,50,25,1352.0,67,161,26,0.416,0.496,49,0.731,19,202720,Jon Leuer,282,565,147,0.499,0.675,98,0.348,187,DET,1610612765,25
222,4.9,7.1,5.4,143,282,69,0.507,0.671,29,0.203,113,54,18,894.0,42,118,10,0.356,0.389,26,0.619,16,201973,Jonas Jerebko,185,400,79,0.463,0.576,55,0.297,129,BOS,1610612738,36
223,3.4,3.9,3.5,364,566,92,0.643,0.768,106,0.291,257,53,23,1428.0,157,365,33,0.43,0.473,132,0.841,28,202685,Jonas Valanciunas,521,931,125,0.56,0.646,238,0.457,285,TOR,1610612761,30
224,9.3,7.6,9.2,21,34,8,0.618,0.808,4,0.19,17,17,13,231.0,1,4,3,0.25,1.0,1,1.0,0,1626780,Jonathan Gibson,22,38,11,0.579,0.815,5,0.227,17,DAL,1610612742,4
225,7.7,10.9,8.1,100,171,40,0.585,0.763,23,0.23,77,50,9,905.0,14,41,7,0.341,0.412,10,0.714,4,203613,Jonathon Simmons,114,212,47,0.538,0.691,33,0.289,81,SAS,1610612759,41
226,9.0,11.3,9.5,129,203,34,0.635,0.763,11,0.085,119,58,39,1587.0,39,103,15,0.379,0.443,18,0.462,20,203903,Jordan Clarkson,168,306,49,0.549,0.654,29,0.173,139,LAL,1610612747,19
227,10.4,19.0,13.3,2,4,1,0.5,0.667,0,0.0,2,2,1,35.0,1,1,0,1.0,1.0,0,0.0,1,200770,Jordan Farmar,3,5,1,0.6,0.75,0,0.0,3,SAC,1610612758,1
228,5.3,4.3,4.7,6,13,5,0.462,0.75,1,0.167,5,5,3,40.0,7,10,2,0.7,0.875,6,0.857,1,201941,Jordan Hill,13,23,7,0.565,0.813,7,0.538,6,MIN,1610612750,2
229,8.7,11.9,9.2,35,70,21,0.5,0.714,5,0.143,29,35,11,380.0,6,13,0,0.462,0.462,2,0.333,4,203895,Jordan McRae,41,83,21,0.494,0.661,7,0.171,33,CLE,1610612739,24
230,3.7,4.1,3.8,15,31,9,0.484,0.682,4,0.267,11,14,8,100.0,12,23,0,0.522,0.522,8,0.667,4,1626175,Jordan Mickey,27,54,9,0.5,0.6,12,0.444,15,BOS,1610612738,6
231,8.2,14.4,9.4,34,52,11,0.654,0.829,7,0.206,26,24,18,292.0,8,12,1,0.667,0.727,4,0.5,4,101181,Jose Calderon,42,64,12,0.656,0.808,11,0.262,30,LAL,1610612747,6
232,9.9,19.3,14.6,2,2,0,1.0,1.0,1,0.5,1,1,1,7.0,2,2,0,1.0,1.0,0,0.0,2,203962,Josh Huestis,4,4,0,1.0,1.0,1,0.25,3,OKC,1610612760,0
233,5.9,7.5,6.4,51,87,20,0.586,0.761,12,0.235,39,22,16,381.0,23,48,2,0.479,0.5,15,0.652,9,201177,Josh McRoberts,74,135,22,0.548,0.655,27,0.365,48,MIA,1610612748,6
234,9.4,11.9,9.8,79,136,43,0.581,0.849,13,0.165,65,28,21,875.0,14,35,7,0.4,0.5,6,0.429,8,1626196,Josh Richardson,93,171,50,0.544,0.769,19,0.204,73,MIA,1610612748,7
235,8.4,8.2,8.4,137,231,59,0.593,0.797,23,0.168,113,42,21,1359.0,33,80,13,0.413,0.493,21,0.636,10,201950,Jrue Holiday,170,311,72,0.547,0.711,44,0.259,123,NOP,1610612740,21
236,5.1,6.8,5.5,85,150,39,0.567,0.766,18,0.212,67,39,23,508.0,31,84,16,0.369,0.456,24,0.774,7,1627823,Juan Hernangomez,116,234,55,0.496,0.648,42,0.362,74,DEN,1610612743,16
237,4.6,6.4,5.0,312,521,108,0.599,0.755,69,0.221,243,50,33,1412.0,91,214,23,0.425,0.476,64,0.703,27,203944,Julius Randle,403,735,131,0.548,0.667,133,0.33,270,LAL,1610612747,17
238,4.8,11.0,6.5,109,165,36,0.661,0.845,17,0.156,92,50,32,707.0,39,69,7,0.565,0.629,24,0.615,15,1626147,Justin Anderson,148,234,43,0.632,0.775,41,0.277,107,DAL,1610612742,18
239,4.3,5.6,4.7,134,251,63,0.534,0.713,36,0.269,97,43,36,826.0,52,115,5,0.452,0.473,42,0.808,10,203120,Justin Hamilton,186,366,68,0.508,0.624,78,0.419,107,BKN,1610612751,7
240,7.9,11.9,8.4,142,224,51,0.634,0.821,40,0.282,103,57,34,1120.0,20,46,6,0.435,0.5,10,0.5,10,203200,Justin Holiday,162,270,57,0.6,0.761,50,0.309,113,NYK,1610612752,23
241,6.4,6.1,6.3,71,148,46,0.48,0.696,15,0.211,56,18,14,625.0,23,62,5,0.371,0.404,13,0.565,10,1626159,Justise Winslow,94,210,51,0.448,0.591,28,0.298,66,MIA,1610612748,4
242,4.1,4.0,4.1,174,311,82,0.559,0.76,48,0.276,127,45,26,821.0,91,241,27,0.378,0.425,72,0.791,19,203994,Jusuf Nurkic,265,552,109,0.48,0.598,120,0.453,146,POR,1610612757,19
243,6.6,4.5,6.1,22,38,8,0.579,0.733,6,0.273,15,28,7,193.0,6,23,2,0.261,0.286,4,0.667,2,203909,KJ McDaniels,28,61,10,0.459,0.549,10,0.357,17,HOU,1610612745,21
244,4.4,5.6,4.7,478,760,149,0.629,0.782,131,0.274,344,57,35,2079.0,197,397,40,0.496,0.552,155,0.787,42,1626157,Karl-Anthony Towns,675,1157,189,0.583,0.697,286,0.424,386,MIN,1610612750,22
245,6.7,7.6,6.9,231,366,78,0.631,0.802,47,0.203,183,49,11,1646.0,55,117,17,0.47,0.55,39,0.709,16,202695,Kawhi Leonard,286,483,95,0.592,0.737,86,0.301,199,SAS,1610612759,38
246,8.5,4.0,8.1,32,47,6,0.681,0.78,4,0.125,28,35,12,342.0,3,11,0,0.273,0.273,3,1.0,0,1627770,Kay Felder,35,58,6,0.603,0.673,7,0.2,28,CLE,1610612739,23
247,5.3,7.3,5.7,196,355,90,0.552,0.74,29,0.148,167,50,17,1077.0,45,152,11,0.296,0.319,28,0.622,17,203482,Kelly Olynyk,241,507,101,0.475,0.594,57,0.237,184,BOS,1610612738,33
248,5.9,7.8,6.3,140,247,62,0.567,0.757,27,0.193,113,52,20,1088.0,39,107,16,0.364,0.429,23,0.59,16,1626162,Kelly Oubre Jr.,179,354,78,0.506,0.649,50,0.279,129,WAS,1610612764,32
249,7.6,9.8,8.0,183,374,116,0.489,0.709,24,0.131,163,53,31,1827.0,33,75,16,0.44,0.559,15,0.455,18,202689,Kemba Walker,216,449,132,0.481,0.681,39,0.181,181,CHA,1610612766,22
250,5.2,5.0,5.1,221,351,80,0.63,0.815,53,0.24,168,46,25,1032.0,145,282,25,0.514,0.564,115,0.793,28,202702,Kenneth Faried,366,633,105,0.578,0.693,168,0.459,196,DEN,1610612743,21
251,6.2,10.2,7.0,136,284,91,0.479,0.705,20,0.147,114,53,24,1450.0,31,57,8,0.544,0.633,20,0.645,11,203145,Kent Bazemore,167,341,99,0.49,0.69,40,0.24,125,ATL,1610612737,29
252,8.9,9.6,9.1,128,186,42,0.688,0.889,15,0.117,112,51,27,1722.0,39,72,7,0.542,0.6,23,0.59,16,203484,Kentavious Caldwell-Pope,167,258,49,0.647,0.799,38,0.228,128,DET,1610612765,24
253,5.9,8.4,6.1,422,595,87,0.709,0.831,89,0.211,333,55,9,1880.0,33,68,8,0.485,0.55,18,0.545,15,201142,Kevin Durant,455,663,95,0.686,0.801,107,0.235,348,GSW,1610612744,46
254,4.4,5.6,4.7,379,585,104,0.648,0.788,79,0.208,302,44,13,1396.0,112,199,19,0.563,0.622,79,0.705,33,201567,Kevin Love,491,784,123,0.626,0.743,158,0.322,335,CLE,1610612739,31
255,4.6,5.8,4.9,70,114,20,0.614,0.745,13,0.186,57,30,18,380.0,29,85,9,0.341,0.382,20,0.69,9,202338,Kevin Seraphin,99,199,29,0.497,0.582,33,0.333,66,IND,1610612754,12
256,5.9,5.0,5.6,70,126,36,0.556,0.778,19,0.271,51,42,6,390.0,34,95,7,0.358,0.386,22,0.647,12,1626172,Kevon Looney,104,221,43,0.471,0.584,41,0.394,63,GSW,1610612744,36
257,5.6,0.0,5.6,8,19,5,0.421,0.571,2,0.25,6,4,2,79.0,0,0,0,0.0,0.0,0,0.0,0,203114,Khris Middleton,8,19,5,0.421,0.571,2,0.25,6,MIL,1610612749,2
258,7.9,12.0,8.6,168,319,68,0.527,0.669,32,0.19,137,53,8,1811.0,36,72,8,0.5,0.563,17,0.472,19,202691,Klay Thompson,204,391,76,0.522,0.648,49,0.24,156,GSW,1610612744,45
259,4.4,4.4,4.4,217,369,90,0.588,0.778,47,0.217,171,57,33,1091.0,90,184,17,0.489,0.539,70,0.778,20,201585,Kosta Koufos,307,553,107,0.555,0.688,117,0.381,191,SAC,1610612758,24
260,5.9,8.7,6.3,99,188,48,0.527,0.707,24,0.242,75,53,32,882.0,16,36,7,0.444,0.552,10,0.625,6,1627739,Kris Dunn,115,224,55,0.513,0.68,34,0.296,81,MIN,1610612750,21
261,4.4,5.6,4.7,105,203,57,0.517,0.719,25,0.238,81,44,18,522.0,45,110,10,0.409,0.45,29,0.644,17,2743,Kris Humphries,150,313,67,0.479,0.61,54,0.36,98,ATL,1610612737,26
262,5.1,6.4,5.4,266,466,96,0.571,0.719,82,0.308,181,49,28,1620.0,82,164,17,0.5,0.558,62,0.756,21,204001,Kristaps Porzingis,348,630,113,0.552,0.673,144,0.414,202,NYK,1610612752,21
263,6.6,7.3,6.7,110,157,26,0.701,0.84,21,0.191,89,49,11,638.0,20,32,1,0.625,0.645,14,0.7,6,203937,Kyle Anderson,130,189,27,0.688,0.802,35,0.269,95,SAS,1610612759,38
264,7.1,21.3,7.8,140,282,68,0.496,0.654,35,0.25,105,50,24,1348.0,7,20,0,0.35,0.35,3,0.429,4,2594,Kyle Korver,147,302,68,0.487,0.628,38,0.259,109,CLE,1610612739,26
265,8.1,10.2,8.5,214,413,111,0.518,0.709,33,0.154,184,54,24,2042.0,46,150,18,0.307,0.348,24,0.522,22,200768,Kyle Lowry,260,563,129,0.462,0.599,57,0.219,206,TOR,1610612761,30
266,4.3,4.7,4.4,196,347,63,0.565,0.69,54,0.276,141,55,33,840.0,110,230,29,0.478,0.547,83,0.755,27,203124,Kyle O'Quinn,306,577,92,0.53,0.631,137,0.448,168,NYK,1610612752,22
267,8.1,9.7,8.3,26,49,18,0.531,0.839,5,0.192,21,26,13,265.0,4,9,0,0.444,0.444,1,0.25,3,202713,Kyle Singler,30,58,18,0.517,0.75,6,0.2,24,OKC,1610612760,13
268,8.5,6.0,7.4,4,9,2,0.444,0.571,0,0.0,4,8,0,28.0,3,4,0,0.75,0.75,3,1.0,0,1627787,Kyle Wiltjer,7,13,2,0.538,0.636,3,0.429,4,HOU,1610612745,8
269,9.6,11.1,10.0,108,200,56,0.54,0.75,23,0.213,83,47,14,1656.0,35,88,10,0.398,0.449,15,0.429,20,202681,Kyrie Irving,143,288,66,0.497,0.644,38,0.266,103,CLE,1610612739,33
270,5.6,4.4,5.2,249,400,93,0.623,0.811,52,0.209,197,49,11,1587.0,113,214,19,0.528,0.579,88,0.779,28,200746,LaMarcus Aldridge,362,614,112,0.59,0.721,140,0.387,225,SAS,1610612759,38
271,7.6,5.6,7.3,5,7,1,0.714,0.833,4,0.8,1,4,3,30.0,1,2,0,0.5,0.5,1,1.0,0,203934,Lamar Patterson,6,9,1,0.667,0.75,5,0.833,1,ATL,1610612737,1
272,7.1,10.5,7.5,21,31,5,0.677,0.808,4,0.19,18,9,7,184.0,3,8,3,0.375,0.6,1,0.333,2,202362,Lance Stephenson,24,39,8,0.615,0.774,5,0.208,20,MIN,1610612750,2
273,7.8,7.9,7.9,46,92,24,0.5,0.676,8,0.174,40,32,21,558.0,16,46,8,0.348,0.421,10,0.625,6,202498,Lance Thomas,62,138,32,0.449,0.585,18,0.29,46,NYK,1610612752,11
274,8.3,10.5,8.7,97,180,53,0.539,0.764,16,0.165,80,54,32,1091.0,20,39,3,0.513,0.556,8,0.4,13,204038,Langston Galloway,117,219,56,0.534,0.718,24,0.205,93,NOP,1610612740,22
275,5.3,5.9,5.5,147,265,61,0.555,0.721,26,0.177,121,39,25,869.0,68,152,16,0.447,0.5,40,0.588,28,1626204,Larry Nance Jr.,215,417,77,0.516,0.632,66,0.307,149,LAL,1610612747,14
276,5.2,4.4,4.9,59,108,22,0.546,0.686,12,0.203,48,37,17,513.0,46,124,20,0.371,0.442,36,0.783,10,202730,Lavoy Allen,105,232,42,0.453,0.553,48,0.457,58,IND,1610612754,20
277,6.7,9.0,7.1,326,495,86,0.659,0.797,50,0.153,277,50,13,1880.0,60,101,5,0.594,0.625,43,0.717,17,2544,LeBron James,386,596,91,0.648,0.764,93,0.241,294,CLE,1610612739,37
278,8.0,12.1,8.6,60,91,20,0.659,0.845,3,0.05,57,50,36,661.0,11,20,5,0.55,0.733,7,0.636,4,2571,Leandro Barbosa,71,111,25,0.64,0.826,10,0.141,61,PHX,1610612756,14
279,9.5,17.5,10.4,118,193,40,0.611,0.771,19,0.161,100,58,39,1403.0,14,49,6,0.286,0.326,6,0.429,8,101150,Lou Williams,132,242,46,0.545,0.673,25,0.189,108,LAL,1610612747,19
280,7.9,9.5,8.4,91,185,54,0.492,0.695,20,0.22,72,53,21,1197.0,36,82,14,0.439,0.529,21,0.583,16,201601,Luc Mbah a Moute,127,267,68,0.476,0.638,41,0.323,88,LAC,1610612746,32
281,4.6,4.9,4.7,149,311,77,0.479,0.637,40,0.268,108,47,21,1015.0,78,169,18,0.462,0.517,58,0.744,19,203512,Lucas Nogueira,227,480,95,0.473,0.59,98,0.432,127,TOR,1610612761,26
282,4.7,5.7,5.0,72,138,32,0.522,0.679,13,0.181,58,31,25,379.0,38,75,3,0.507,0.528,25,0.658,13,2449,Luis Scola,110,213,35,0.516,0.618,38,0.345,71,BKN,1610612751,6
283,6.4,21.4,8.1,87,189,68,0.46,0.719,15,0.172,72,48,25,752.0,11,25,5,0.44,0.55,1,0.091,10,202337,Luke Babbitt,98,214,73,0.458,0.695,16,0.163,82,MIA,1610612748,23
284,6.0,7.4,6.3,228,403,97,0.566,0.745,47,0.206,179,54,36,1455.0,61,143,23,0.427,0.508,41,0.672,20,2736,Luol Deng,289,546,120,0.529,0.678,88,0.304,199,LAL,1610612747,18
285,6.5,19.6,8.2,20,28,2,0.714,0.769,3,0.15,17,22,13,198.0,3,5,0,0.6,0.6,0,0.0,3,1627781,Malachi Richardson,23,33,2,0.697,0.742,3,0.13,20,SAC,1610612758,9
286,8.3,11.8,9.1,113,204,50,0.554,0.734,20,0.177,91,53,30,1368.0,32,52,5,0.615,0.681,14,0.438,18,1627763,Malcolm Brogdon,145,256,55,0.566,0.721,34,0.234,109,MIL,1610612749,23
287,7.6,17.7,8.5,91,163,48,0.558,0.791,11,0.121,80,55,24,975.0,7,18,4,0.389,0.5,5,0.714,3,1627098,Malcolm Delaney,98,181,52,0.541,0.76,16,0.163,83,ATL,1610612737,31
288,4.3,3.7,4.2,5,10,5,0.5,1.0,1,0.2,4,18,11,84.0,1,4,0,0.25,0.25,1,1.0,0,1627736,Malik Beasley,6,14,5,0.429,0.667,2,0.333,4,DEN,1610612743,7
289,7.4,11.9,8.2,90,142,26,0.634,0.776,14,0.156,75,47,11,865.0,18,49,5,0.367,0.409,7,0.389,11,1938,Manu Ginobili,108,191,31,0.565,0.675,21,0.194,86,SAS,1610612759,36
290,5.1,9.6,5.7,289,506,111,0.571,0.732,92,0.318,196,54,21,1854.0,44,110,13,0.4,0.454,27,0.614,17,201188,Marc Gasol,333,616,124,0.541,0.677,119,0.357,213,MEM,1610612763,33
291,12.7,14.1,12.8,22,31,4,0.71,0.815,2,0.091,20,23,18,237.0,2,6,1,0.333,0.4,0,0.0,2,1626273,Marcelo Huertas,24,37,5,0.649,0.75,2,0.083,22,LAL,1610612747,5
292,4.0,5.4,4.4,441,745,138,0.592,0.727,104,0.236,336,54,20,1855.0,176,428,35,0.411,0.448,134,0.761,40,101162,Marcin Gortat,617,1173,173,0.526,0.617,238,0.386,376,WAS,1610612764,34
293,7.9,14.0,8.4,114,181,32,0.63,0.765,12,0.105,103,49,29,1209.0,9,20,1,0.45,0.474,5,0.556,4,201158,Marco Belinelli,123,201,33,0.612,0.732,17,0.138,107,CHA,1610612766,20
294,6.8,8.3,7.1,208,380,111,0.547,0.773,41,0.197,166,55,28,1817.0,50,101,14,0.495,0.575,34,0.68,17,202694,Marcus Morris,258,481,125,0.536,0.725,75,0.291,183,DET,1610612765,27
295,7.9,7.7,7.9,152,274,62,0.555,0.717,34,0.224,118,52,18,1616.0,51,121,12,0.421,0.468,36,0.706,15,203935,Marcus Smart,203,395,74,0.514,0.632,70,0.345,133,BOS,1610612738,34
296,7.6,6.5,7.3,54,84,19,0.643,0.831,8,0.148,45,32,17,561.0,22,49,4,0.449,0.489,14,0.636,8,201977,Marcus Thornton,76,133,23,0.571,0.691,22,0.289,53,WAS,1610612764,15
297,5.4,13.6,6.6,59,104,23,0.567,0.728,10,0.169,51,41,29,467.0,10,23,3,0.435,0.5,6,0.6,4,1626209,Mario Hezonja,69,127,26,0.543,0.683,16,0.232,55,ORL,1610612753,12
298,5.2,5.9,5.4,279,474,104,0.589,0.754,59,0.211,220,52,20,1663.0,79,158,10,0.5,0.534,57,0.722,22,202693,Markieff Morris,358,632,114,0.566,0.691,116,0.324,242,WAS,1610612764,32
299,5.6,4.7,5.3,127,222,56,0.572,0.765,33,0.26,94,54,38,1021.0,63,158,21,0.399,0.46,44,0.698,19,1627737,Marquese Chriss,190,380,77,0.5,0.627,77,0.405,113,PHX,1610612756,16
300,4.0,4.4,4.1,196,342,68,0.573,0.715,53,0.27,145,55,21,912.0,63,134,11,0.47,0.512,53,0.841,10,201578,Marreese Speights,259,476,79,0.544,0.652,106,0.409,155,LAC,1610612746,34
301,7.5,5.4,6.5,9,13,1,0.692,0.75,1,0.111,8,8,5,65.0,8,19,1,0.421,0.444,5,0.625,3,1627850,Marshall Plumlee,17,32,2,0.531,0.567,6,0.353,11,NYK,1610612752,3
302,5.8,8.0,6.2,228,382,109,0.597,0.835,29,0.127,194,48,30,1374.0,45,108,14,0.417,0.479,27,0.6,19,101107,Marvin Williams,273,490,123,0.557,0.744,56,0.205,213,CHA,1610612766,18
303,4.2,5.0,4.4,320,546,102,0.586,0.721,92,0.288,229,55,32,1550.0,122,319,38,0.382,0.434,87,0.713,35,203486,Mason Plumlee,442,865,140,0.511,0.61,179,0.405,264,DEN,1610612743,23
304,5.2,6.3,5.4,238,383,81,0.621,0.788,45,0.189,192,54,32,1366.0,55,116,8,0.474,0.509,36,0.655,19,2440,Matt Barnes,293,499,89,0.587,0.715,81,0.276,211,SAC,1610612758,22
305,10.3,10.9,10.4,79,179,58,0.441,0.653,9,0.114,73,48,28,1265.0,16,50,5,0.32,0.356,10,0.625,6,203521,Matthew Dellavedova,95,229,63,0.415,0.572,19,0.2,79,MIL,1610612749,20
306,7.2,5.3,6.5,157,282,65,0.557,0.724,39,0.248,116,52,31,1504.0,87,208,24,0.418,0.473,64,0.736,23,203090,Maurice Harkless,244,490,89,0.498,0.608,103,0.422,139,POR,1610612757,21
307,5.4,8.4,6.3,19,36,7,0.528,0.655,4,0.211,16,20,14,144.0,9,26,1,0.346,0.36,3,0.333,6,1626254,Maurice Ndour,28,62,8,0.452,0.519,7,0.25,22,NYK,1610612752,6
308,6.1,11.0,7.8,6,13,4,0.462,0.667,0,0.0,6,18,14,81.0,3,7,1,0.429,0.5,2,0.667,1,1897,Metta World Peace,9,20,5,0.45,0.6,2,0.222,7,LAL,1610612747,4
309,5.0,5.3,5.0,135,249,62,0.542,0.722,33,0.244,102,48,29,784.0,19,56,8,0.339,0.396,9,0.474,10,203086,Meyers Leonard,154,305,70,0.505,0.655,42,0.273,112,POR,1610612757,19
310,4.8,6.0,5.1,131,202,44,0.649,0.829,35,0.267,98,45,27,770.0,34,61,6,0.557,0.618,29,0.853,5,201563,Michael Beasley,165,263,50,0.627,0.775,64,0.388,103,MIL,1610612749,18
311,6.2,9.4,6.7,102,139,22,0.734,0.872,27,0.265,75,25,11,574.0,18,40,4,0.45,0.5,10,0.556,8,203487,Michael Carter-Williams,120,179,26,0.67,0.784,37,0.308,83,CHI,1610612741,14
312,6.1,2.6,3.8,1,3,1,0.333,0.5,0,0.0,1,9,2,32.0,2,3,0,0.667,0.667,1,0.5,1,1627771,Michael Gbinije,3,6,1,0.5,0.6,1,0.333,2,DET,1610612765,7
313,5.5,6.8,5.8,294,502,125,0.586,0.78,58,0.197,236,53,31,1582.0,110,260,33,0.423,0.485,79,0.718,30,203077,Michael Kidd-Gilchrist,404,762,158,0.53,0.669,137,0.339,266,CHA,1610612766,22
314,9.6,16.8,10.7,136,226,49,0.602,0.768,23,0.169,115,45,19,1465.0,25,48,2,0.521,0.543,9,0.36,16,201144,Mike Conley,161,274,51,0.588,0.722,32,0.199,131,MEM,1610612763,26
315,7.0,10.3,7.4,78,153,40,0.51,0.69,14,0.179,64,39,12,633.0,11,40,7,0.275,0.333,9,0.818,2,2399,Mike Dunleavy,89,193,47,0.461,0.61,23,0.258,66,ATL,1610612737,27
316,5.6,12.1,6.3,16,22,6,0.727,1.0,2,0.125,14,12,9,76.0,1,5,2,0.2,0.333,1,1.0,1,2034,Mike Miller,17,27,8,0.63,0.895,3,0.176,15,DEN,1610612743,3
317,5.2,6.5,5.6,121,255,77,0.475,0.68,31,0.256,90,49,22,963.0,60,138,10,0.435,0.469,46,0.767,15,203488,Mike Muscala,181,393,87,0.461,0.592,77,0.425,105,ATL,1610612737,27
318,6.8,7.9,7.1,27,45,8,0.6,0.73,4,0.148,23,18,11,195.0,10,28,5,0.357,0.435,5,0.5,5,203118,Mike Scott,37,73,13,0.507,0.617,9,0.243,28,ATL,1610612737,7
319,6.5,11.7,10.0,1,1,0,1.0,1.0,0,0.0,1,1,1,11.0,2,5,0,0.4,0.4,2,1.0,0,1627861,Mike Tobey,3,6,0,0.5,0.5,2,0.667,1,CHA,1610612766,0
320,4.7,6.5,5.4,42,104,23,0.404,0.519,14,0.333,30,35,21,347.0,27,73,6,0.37,0.403,16,0.593,10,203101,Miles Plumlee,69,177,29,0.39,0.466,30,0.435,40,CHA,1610612766,14
321,8.3,5.8,7.4,57,111,26,0.514,0.671,13,0.228,44,47,29,686.0,32,91,17,0.352,0.432,24,0.75,9,1627851,Mindaugas Kuzminskas,89,202,43,0.441,0.56,37,0.416,53,NYK,1610612752,18
322,6.0,7.8,6.2,99,169,40,0.586,0.767,17,0.172,84,44,25,720.0,10,25,5,0.4,0.5,6,0.6,4,203141,Mirza Teletovic,109,194,45,0.562,0.732,23,0.211,88,MIL,1610612749,19
323,9.3,9.8,9.4,113,168,26,0.673,0.796,17,0.15,96,44,20,1181.0,7,23,4,0.304,0.368,2,0.286,5,101145,Monta Ellis,120,191,30,0.628,0.745,19,0.158,101,IND,1610612754,24
324,5.6,5.5,5.6,106,210,38,0.505,0.616,33,0.311,73,45,12,863.0,67,152,18,0.441,0.5,48,0.716,20,1626149,Montrezl Harrell,173,362,56,0.478,0.565,81,0.468,93,HOU,1610612745,33
325,4.1,5.3,4.4,293,568,128,0.516,0.666,99,0.338,192,51,24,1606.0,84,188,13,0.447,0.48,57,0.679,27,1626167,Myles Turner,377,756,141,0.499,0.613,156,0.414,219,IND,1610612754,27
326,5.4,7.5,5.8,143,266,77,0.538,0.757,39,0.273,104,55,33,947.0,37,88,8,0.42,0.463,27,0.73,10,202357,Nemanja Bjelica,180,354,85,0.508,0.669,66,0.367,114,MIN,1610612750,22
327,4.4,7.3,5.3,126,247,77,0.51,0.741,33,0.262,92,47,14,809.0,55,136,11,0.404,0.44,39,0.709,16,2403,Nene,181,383,88,0.473,0.614,72,0.398,108,HOU,1610612745,33
328,4.3,3.5,4.0,98,194,34,0.505,0.613,28,0.286,70,29,15,564.0,46,121,12,0.38,0.422,29,0.63,19,203457,Nerlens Noel,144,315,46,0.457,0.535,57,0.396,89,PHI,1610612755,14
329,6.3,4.3,5.7,11,15,2,0.733,0.846,2,0.182,8,14,9,81.0,4,13,2,0.308,0.364,3,0.75,1,2555,Nick Collison,15,28,4,0.536,0.625,5,0.333,9,OKC,1610612760,5
330,8.6,15.1,9.9,96,184,40,0.522,0.667,17,0.177,78,51,33,1351.0,24,52,5,0.462,0.511,11,0.458,13,201156,Nick Young,120,236,45,0.508,0.628,28,0.233,91,LAL,1610612747,18
331,5.6,9.0,6.0,321,476,88,0.674,0.827,51,0.159,271,51,30,1768.0,38,85,7,0.447,0.487,25,0.658,13,201587,Nicolas Batum,359,561,95,0.64,0.77,76,0.212,284,CHA,1610612766,21
332,5.9,14.0,7.8,33,53,13,0.623,0.825,6,0.182,27,36,25,246.0,10,16,2,0.625,0.714,6,0.6,4,1627852,Nicolas Brussino,43,69,15,0.623,0.796,12,0.279,31,DAL,1610612742,11
333,12.4,22.2,13.5,8,17,5,0.471,0.667,1,0.125,7,17,3,156.0,1,9,0,0.111,0.111,0,0.0,1,1627879,Nicolas Laprovittola,9,26,5,0.346,0.429,1,0.111,8,SAS,1610612759,14
334,8.1,21.8,9.3,131,233,55,0.562,0.736,26,0.198,105,52,32,1423.0,14,33,7,0.424,0.538,2,0.143,11,203917,Nik Stauskas,145,266,62,0.545,0.711,28,0.193,116,PHI,1610612755,20
335,4.4,4.7,4.5,279,470,106,0.594,0.766,82,0.294,196,48,26,1289.0,150,305,30,0.492,0.545,114,0.76,37,203999,Nikola Jokic,429,775,136,0.554,0.671,196,0.457,233,DEN,1610612743,22
336,5.1,8.0,5.5,197,326,76,0.604,0.788,52,0.264,145,45,22,1005.0,34,62,5,0.548,0.596,21,0.618,13,202703,Nikola Mirotic,231,388,81,0.595,0.752,73,0.316,158,CHI,1610612741,23
337,4.3,5.5,4.5,430,618,100,0.696,0.83,94,0.219,337,55,35,1569.0,121,241,24,0.502,0.558,95,0.785,25,202696,Nikola Vucevic,551,859,124,0.641,0.75,189,0.343,362,ORL,1610612753,20
338,3.8,4.2,3.9,135,236,57,0.572,0.754,34,0.252,101,48,28,634.0,66,171,16,0.386,0.426,51,0.773,14,203943,Noah Vonleh,201,407,73,0.494,0.602,85,0.423,115,POR,1610612757,20
339,6.6,11.9,7.5,82,161,43,0.509,0.695,14,0.171,68,51,22,878.0,17,39,3,0.436,0.472,8,0.471,9,1626181,Norman Powell,99,200,46,0.495,0.643,22,0.222,77,TOR,1610612761,29
340,4.5,7.3,5.2,26,56,16,0.464,0.65,6,0.231,20,14,2,226.0,9,27,3,0.333,0.375,5,0.556,4,1627855,Okaro White,35,83,19,0.422,0.547,11,0.314,24,MIA,1610612748,12
341,4.3,3.8,4.2,105,191,43,0.55,0.709,22,0.21,83,30,18,457.0,46,93,5,0.495,0.523,33,0.717,13,201600,Omer Asik,151,284,48,0.532,0.64,55,0.364,96,NOP,1610612740,12
342,5.0,6.6,5.3,70,128,33,0.547,0.737,6,0.086,64,22,13,397.0,20,45,2,0.444,0.465,15,0.75,5,201956,Omri Casspi,90,173,35,0.52,0.652,21,0.233,69,SAC,1610612758,9
343,5.6,8.5,6.2,288,501,109,0.575,0.735,62,0.215,228,54,20,1824.0,68,158,27,0.43,0.519,42,0.618,26,203490,Otto Porter,356,659,136,0.54,0.681,104,0.292,254,WAS,1610612764,34
344,5.6,7.1,6.0,230,381,85,0.604,0.777,43,0.187,186,54,38,1538.0,91,197,32,0.462,0.552,56,0.615,34,200782,PJ Tucker,321,578,117,0.555,0.696,99,0.308,220,PHX,1610612756,16
345,5.6,6.7,6.0,101,166,31,0.608,0.748,25,0.248,76,46,17,761.0,59,127,11,0.465,0.509,38,0.644,20,1627783,Pascal Siakam,160,293,42,0.546,0.637,63,0.394,96,TOR,1610612761,29
346,6.0,10.2,7.3,22,41,13,0.537,0.786,5,0.227,17,27,18,195.0,9,14,2,0.643,0.75,4,0.444,5,1626192,Pat Connaughton,31,55,15,0.564,0.775,9,0.29,22,POR,1610612757,9
347,7.5,9.7,8.0,191,317,72,0.603,0.78,31,0.162,161,44,13,1343.0,57,152,12,0.375,0.407,30,0.526,27,201976,Patrick Beverley,248,469,84,0.529,0.644,61,0.246,188,HOU,1610612745,31
348,8.2,8.0,8.1,37,67,18,0.552,0.755,9,0.243,28,46,8,571.0,9,33,6,0.273,0.333,4,0.444,5,1627775,Patrick McCaw,46,100,24,0.46,0.605,13,0.283,33,GSW,1610612744,38
349,5.9,7.4,6.2,169,266,57,0.635,0.809,35,0.207,132,39,16,1060.0,46,87,8,0.529,0.582,34,0.739,12,202335,Patrick Patterson,215,353,65,0.609,0.747,69,0.321,144,TOR,1610612761,23
350,11.5,18.5,12.8,79,124,18,0.637,0.745,8,0.101,72,54,12,1141.0,18,31,6,0.581,0.72,5,0.278,13,201988,Patty Mills,97,155,24,0.626,0.74,13,0.134,85,SAS,1610612759,42
351,4.1,5.5,4.4,235,360,70,0.653,0.81,56,0.238,180,37,8,979.0,58,133,9,0.436,0.468,44,0.759,14,2200,Pau Gasol,293,493,79,0.594,0.708,100,0.341,194,SAS,1610612759,29
352,5.6,7.8,5.9,243,407,92,0.597,0.771,36,0.148,207,45,21,1624.0,37,96,11,0.385,0.435,23,0.622,14,202331,Paul George,280,503,103,0.557,0.7,59,0.211,221,IND,1610612754,24
353,4.9,7.4,5.4,318,587,137,0.542,0.707,78,0.245,241,52,21,1776.0,88,245,30,0.359,0.409,63,0.716,25,200794,Paul Millsap,406,832,167,0.488,0.611,141,0.347,266,ATL,1610612737,31
354,7.7,0.0,7.7,18,37,9,0.486,0.643,5,0.278,13,13,6,153.0,0,1,0,0.0,0.0,0,0.0,0,1718,Paul Pierce,18,38,9,0.474,0.621,5,0.278,13,LAC,1610612746,7
355,6.3,8.0,6.5,42,78,22,0.538,0.75,7,0.167,35,21,11,338.0,7,18,4,0.389,0.5,5,0.714,2,1627835,Paul Zipser,49,96,26,0.51,0.7,12,0.245,37,CHI,1610612741,10
356,10.3,26.7,12.1,8,17,6,0.471,0.727,2,0.25,6,9,5,84.0,1,4,1,0.25,0.333,0,0.0,1,203510,Pierre Jackson,9,21,7,0.429,0.643,2,0.222,7,DAL,1610612742,4
357,3.5,5.5,4.1,26,49,11,0.531,0.684,6,0.231,20,18,17,182.0,13,29,1,0.448,0.464,10,0.769,3,203112,Quincy Acy,39,78,12,0.5,0.591,16,0.41,23,BKN,1610612751,1
358,13.0,0.0,13.0,1,1,0,1.0,1.0,0,0.0,1,3,1,9.0,0,0,0,0.0,0.0,0,0.0,0,1626154,RJ Hunter,1,1,0,1.0,1.0,0,0.0,1,CHI,1610612741,2
359,7.0,12.4,8.0,196,299,63,0.656,0.831,22,0.112,173,45,23,1172.0,40,94,9,0.426,0.471,17,0.425,23,200765,Rajon Rondo,236,393,72,0.601,0.735,39,0.165,196,CHI,1610612741,22
360,5.8,4.7,5.3,5,10,2,0.5,0.625,1,0.2,4,7,5,23.0,4,7,0,0.571,0.571,4,1.0,0,1626176,Rakeem Christmas,9,17,2,0.529,0.6,5,0.556,4,IND,1610612754,2
361,10.1,15.8,10.9,59,89,16,0.663,0.808,4,0.068,56,48,27,768.0,11,25,1,0.44,0.458,7,0.636,4,201196,Ramon Sessions,70,114,17,0.614,0.722,11,0.157,60,CHA,1610612766,21
362,8.2,14.6,8.7,96,189,50,0.508,0.691,14,0.146,81,42,36,806.0,8,19,0,0.421,0.421,5,0.625,3,200751,Randy Foye,104,208,50,0.5,0.658,19,0.183,84,BKN,1610612751,6
363,6.6,23.6,7.2,26,43,9,0.605,0.765,7,0.269,19,22,13,249.0,1,5,1,0.2,0.25,0,0.0,1,1626173,Rashad Vaughn,27,48,10,0.563,0.711,7,0.259,20,MIL,1610612749,9
364,11.0,22.2,11.6,19,34,9,0.559,0.76,0,0.0,19,29,11,213.0,1,2,0,0.5,0.5,0,0.0,1,203526,Raul Neto,20,36,9,0.556,0.741,0,0.0,20,UTA,1610612762,18
365,9.0,10.8,9.3,134,221,52,0.606,0.793,28,0.209,106,53,20,1216.0,27,68,5,0.397,0.429,10,0.37,17,101109,Raymond Felton,161,289,57,0.557,0.694,38,0.236,123,LAC,1610612746,33
366,6.9,9.5,7.4,21,38,11,0.553,0.778,7,0.333,15,14,8,217.0,6,12,3,0.5,0.667,2,0.333,4,203493,Reggie Bullock,27,50,14,0.54,0.75,9,0.333,19,DET,1610612765,6
367,8.3,12.0,9.0,66,132,44,0.5,0.75,8,0.121,58,36,20,1023.0,15,46,8,0.326,0.395,8,0.533,7,202704,Reggie Jackson,81,178,52,0.455,0.643,16,0.198,65,DET,1610612765,16
368,5.5,14.8,8.6,4,10,3,0.4,0.571,0,0.0,4,5,4,63.0,2,2,0,1.0,1.0,1,0.5,1,202130,Reggie Williams,6,12,3,0.5,0.667,1,0.167,5,NOP,1610612740,1
369,6.9,10.9,7.6,101,211,60,0.479,0.669,24,0.238,76,52,15,1024.0,21,57,9,0.368,0.438,9,0.429,12,2210,Richard Jefferson,122,268,69,0.455,0.613,33,0.27,88,CLE,1610612739,37
370,4.4,5.1,4.7,79,153,37,0.516,0.681,18,0.228,61,30,21,466.0,47,104,15,0.452,0.528,34,0.723,12,1626158,Richaun Holmes,126,257,52,0.49,0.615,52,0.413,73,PHI,1610612755,9
371,9.2,13.4,10.2,147,265,63,0.555,0.728,19,0.129,128,51,32,1637.0,47,86,4,0.547,0.573,19,0.404,29,201937,Ricky Rubio,194,351,67,0.553,0.683,38,0.196,157,MIN,1610612750,19
372,5.4,8.8,6.2,225,440,136,0.511,0.74,55,0.244,169,48,27,1491.0,69,157,19,0.439,0.5,43,0.623,25,203496,Robert Covington,294,597,155,0.492,0.665,98,0.333,194,PHI,1610612755,21
373,5.4,3.8,4.6,190,405,108,0.469,0.64,64,0.337,125,54,27,1534.0,186,421,47,0.442,0.497,162,0.871,25,201577,Robin Lopez,376,826,155,0.455,0.56,226,0.601,150,CHI,1610612741,27
374,7.4,14.4,7.9,129,226,56,0.571,0.759,20,0.155,109,39,12,1121.0,10,26,6,0.385,0.5,5,0.5,5,203918,Rodney Hood,139,252,62,0.552,0.732,25,0.18,114,UTA,1610612762,27
375,8.3,9.2,8.6,111,224,68,0.496,0.712,22,0.198,91,53,29,1390.0,71,165,20,0.43,0.49,37,0.521,32,203585,Rodney McGruder,182,389,88,0.468,0.605,59,0.324,123,MIA,1610612748,24
376,8.4,14.2,8.8,51,73,15,0.699,0.879,10,0.196,41,25,15,465.0,4,9,0,0.444,0.444,1,0.25,3,201155,Rodney Stuckey,55,82,15,0.671,0.821,11,0.2,44,IND,1610612754,10
377,8.6,5.8,8.2,35,56,7,0.625,0.714,10,0.286,25,28,21,328.0,6,8,0,0.75,0.75,4,0.667,2,1627758,Ron Baker,41,64,7,0.641,0.719,14,0.341,27,NYK,1610612752,7
378,5.4,6.0,5.5,201,340,68,0.591,0.739,43,0.214,159,47,40,1006.0,41,117,13,0.35,0.394,27,0.659,14,1626178,Rondae Hollis-Jefferson,242,457,81,0.53,0.644,70,0.289,173,BKN,1610612751,7
379,0.0,0.0,0.0,0,2,0,0.0,0.0,0,0.0,0,2,1,7.0,0,0,0,0.0,0.0,0,0.0,0,101179,Ronnie Price,0,2,0,0.0,0.0,0,0.0,0,PHX,1610612756,1
380,5.0,3.4,4.4,97,218,76,0.445,0.683,25,0.258,73,42,23,671.0,53,123,10,0.431,0.469,43,0.811,10,201579,Roy Hibbert,150,341,86,0.44,0.588,68,0.453,83,MIL,1610612749,19
381,5.9,7.2,6.1,155,222,36,0.698,0.833,33,0.213,121,30,19,1013.0,35,77,14,0.455,0.556,24,0.686,11,200752,Rudy Gay,190,299,50,0.635,0.763,57,0.3,132,SAC,1610612758,11
382,3.9,4.7,4.2,495,802,156,0.617,0.766,106,0.214,390,56,21,1881.0,218,426,24,0.512,0.542,167,0.766,50,203497,Rudy Gobert,713,1228,180,0.581,0.68,273,0.383,440,UTA,1610612762,35
383,5.8,8.7,6.3,489,620,82,0.789,0.909,65,0.133,425,56,24,1945.0,103,202,26,0.51,0.585,60,0.583,45,201566,Russell Westbrook,592,822,108,0.72,0.829,125,0.211,470,OKC,1610612760,32
384,6.0,5.3,5.8,184,338,82,0.544,0.719,45,0.245,138,54,16,1664.0,90,182,13,0.495,0.533,65,0.722,25,201583,Ryan Anderson,274,520,95,0.527,0.645,110,0.401,163,HOU,1610612745,38
385,2.9,0.0,2.9,10,17,3,0.588,0.714,5,0.5,5,8,6,46.0,0,4,1,0.0,0.0,0,0.0,0,203527,Ryan Kelly,10,21,4,0.476,0.588,5,0.5,5,ATL,1610612737,2
386,4.6,5.8,5.0,153,247,40,0.619,0.739,46,0.301,107,49,31,651.0,69,171,7,0.404,0.421,52,0.754,17,1626257,Salah Mejri,222,418,47,0.531,0.598,98,0.441,124,DAL,1610612742,18
387,6.9,6.0,6.6,142,244,51,0.582,0.736,24,0.169,116,57,17,1126.0,78,151,15,0.517,0.574,55,0.705,25,1626155,Sam Dekker,220,395,66,0.557,0.669,79,0.359,141,HOU,1610612745,40
388,9.5,8.0,9.4,30,49,11,0.612,0.789,4,0.133,26,28,18,230.0,3,6,0,0.5,0.5,3,1.0,0,2756,Sasha Vujacic,33,55,11,0.6,0.75,7,0.212,26,NYK,1610612752,10
389,6.5,9.9,6.8,188,311,71,0.605,0.783,28,0.149,160,50,43,1296.0,17,44,8,0.386,0.472,6,0.353,11,203930,Sean Kilpatrick,205,355,79,0.577,0.743,34,0.166,171,BKN,1610612751,7
390,8.1,11.9,9.0,40,69,20,0.58,0.816,7,0.175,34,39,18,571.0,13,33,5,0.394,0.464,4,0.308,9,203902,Semaj Christon,53,102,25,0.52,0.688,11,0.208,43,OKC,1610612760,21
391,4.5,5.6,4.8,282,473,124,0.596,0.808,66,0.234,216,56,35,1710.0,100,208,25,0.481,0.546,75,0.75,25,201586,Serge Ibaka,382,681,149,0.561,0.718,141,0.369,241,TOR,1610612761,21
392,10.8,18.6,11.7,103,138,21,0.746,0.88,8,0.078,97,49,31,1095.0,14,23,0,0.609,0.609,3,0.214,11,200771,Sergio Rodriguez,117,161,21,0.727,0.836,11,0.094,108,PHI,1610612755,18
393,9.6,14.0,10.4,108,186,43,0.581,0.755,13,0.12,95,51,31,1444.0,22,41,2,0.537,0.564,8,0.364,14,203552,Seth Curry,130,227,45,0.573,0.714,21,0.162,109,DAL,1610612742,20
394,6.2,7.0,6.5,99,149,32,0.664,0.846,17,0.172,82,53,33,1040.0,53,135,17,0.393,0.449,43,0.811,10,203498,Shabazz Muhammad,152,284,49,0.535,0.647,60,0.395,92,MIN,1610612750,20
395,11.1,13.0,11.2,21,41,7,0.512,0.618,2,0.095,19,32,20,246.0,2,7,0,0.286,0.286,1,0.5,1,203894,Shabazz Napier,23,48,7,0.479,0.561,3,0.13,20,POR,1610612757,12
396,8.6,8.8,8.7,79,122,17,0.648,0.752,18,0.228,61,50,8,867.0,18,36,5,0.5,0.581,13,0.722,5,2733,Shaun Livingston,97,158,22,0.614,0.713,31,0.32,66,GSW,1610612744,42
397,7.2,11.2,7.8,26,43,10,0.605,0.788,3,0.115,23,25,10,248.0,4,14,3,0.286,0.364,1,0.25,3,1627815,Sheldon McClellan,30,57,13,0.526,0.682,4,0.133,26,WAS,1610612764,15
398,7.6,17.9,9.3,81,145,36,0.559,0.743,10,0.123,73,45,18,962.0,16,40,7,0.4,0.485,2,0.125,14,202714,Shelvin Mack,97,185,43,0.524,0.683,12,0.124,87,UTA,1610612762,27
399,5.9,6.6,6.3,5,15,5,0.333,0.5,2,0.4,3,8,7,52.0,7,15,1,0.467,0.5,4,0.571,3,1627746,Skal Labissiere,12,30,6,0.4,0.5,6,0.5,6,SAC,1610612758,1
400,6.9,8.3,7.1,169,307,82,0.55,0.751,29,0.172,140,54,31,1536.0,28,81,10,0.346,0.394,12,0.429,16,203524,Solomon Hill,197,388,92,0.508,0.666,41,0.208,156,NOP,1610612740,23
401,7.3,11.8,7.9,72,115,23,0.626,0.783,8,0.111,64,32,30,683.0,11,29,3,0.379,0.423,6,0.545,5,203915,Spencer Dinwiddie,83,144,26,0.576,0.703,14,0.169,69,BKN,1610612751,2
402,5.1,4.9,5.0,99,189,55,0.524,0.739,25,0.253,74,33,20,578.0,29,63,2,0.46,0.475,16,0.552,13,201150,Spencer Hawes,128,252,57,0.508,0.656,41,0.32,87,MIL,1610612749,13
403,5.2,8.2,5.8,93,180,58,0.517,0.762,23,0.247,70,52,27,870.0,24,44,4,0.545,0.6,15,0.625,9,1626169,Stanley Johnson,117,224,62,0.522,0.722,38,0.325,79,DET,1610612765,25
404,8.9,12.1,9.4,202,334,75,0.605,0.78,35,0.173,169,54,9,1808.0,32,89,7,0.36,0.39,20,0.625,12,201939,Stephen Curry,234,423,82,0.553,0.686,55,0.235,181,GSW,1610612744,45
405,5.4,7.7,6.0,11,14,2,0.786,0.917,3,0.273,8,9,6,36.0,4,12,1,0.333,0.364,3,0.75,1,1627757,Stephen Zimmerman,15,26,3,0.577,0.652,6,0.4,9,ORL,1610612753,3
406,6.6,0.0,6.6,3,6,2,0.5,0.75,0,0.0,3,8,2,22.0,0,0,0,0.0,0.0,0,0.0,0,200779,Steve Novak,3,6,2,0.5,0.75,0,0.0,3,MIL,1610612749,6
407,5.1,4.3,4.7,243,440,119,0.552,0.757,65,0.267,180,54,22,1672.0,188,432,55,0.435,0.499,145,0.771,43,203500,Steven Adams,431,872,174,0.494,0.617,210,0.487,223,OKC,1610612760,32
408,9.5,14.4,10.1,140,252,64,0.556,0.745,22,0.157,117,53,33,1331.0,21,52,10,0.404,0.5,8,0.381,13,204456,T.J. McConnell,161,304,74,0.53,0.7,30,0.186,130,PHI,1610612755,20
409,7.6,8.2,7.9,94,167,42,0.563,0.752,25,0.266,70,41,29,1184.0,67,139,17,0.482,0.549,46,0.687,22,203933,TJ Warren,161,306,59,0.526,0.652,71,0.441,92,PHX,1610612756,12
410,5.2,5.5,5.3,245,408,86,0.6,0.761,63,0.257,182,52,26,1427.0,108,279,34,0.387,0.441,86,0.796,20,201959,Taj Gibson,353,687,120,0.514,0.623,149,0.422,202,CHI,1610612741,26
411,4.3,4.4,4.4,145,252,53,0.575,0.729,39,0.269,106,46,28,749.0,105,221,26,0.475,0.538,77,0.733,28,204028,Tarik Black,250,473,79,0.529,0.635,116,0.464,134,LAL,1610612747,18
412,6.4,10.3,6.8,58,99,20,0.586,0.734,9,0.155,49,32,16,351.0,7,17,4,0.412,0.538,5,0.714,2,1627752,Taurean Prince,65,116,24,0.56,0.707,14,0.215,51,ATL,1610612737,16
413,4.8,5.7,5.0,233,403,95,0.578,0.756,60,0.258,172,50,31,1236.0,63,152,9,0.414,0.441,48,0.762,16,203093,Terrence Jones,296,555,104,0.533,0.656,108,0.365,188,NOP,1610612740,19
414,5.9,13.4,6.6,120,209,48,0.574,0.745,31,0.258,90,52,23,1167.0,12,22,4,0.545,0.667,5,0.417,7,203082,Terrence Ross,132,231,52,0.571,0.737,36,0.273,97,ORL,1610612753,29
415,6.4,10.0,7.1,126,227,66,0.555,0.783,29,0.23,97,50,18,912.0,28,70,9,0.4,0.459,15,0.536,13,1626179,Terry Rozier,154,297,75,0.519,0.694,44,0.286,110,BOS,1610612738,32
416,6.0,7.3,6.2,153,285,76,0.537,0.732,25,0.163,129,43,18,1113.0,32,92,14,0.348,0.41,19,0.594,12,200757,Thabo Sefolosha,185,377,90,0.491,0.645,44,0.238,141,ATL,1610612737,25
417,6.1,8.0,6.6,208,373,89,0.558,0.732,50,0.24,158,44,19,1391.0,68,174,14,0.391,0.425,41,0.603,27,201152,Thaddeus Young,276,547,103,0.505,0.622,91,0.33,185,IND,1610612754,25
418,4.1,4.7,4.3,91,144,26,0.632,0.771,26,0.286,65,34,24,374.0,59,110,9,0.536,0.584,41,0.695,18,203080,Thomas Robinson,150,254,35,0.591,0.685,67,0.447,83,LAL,1610612747,10
419,6.0,5.6,5.8,35,61,10,0.574,0.686,6,0.171,29,29,16,217.0,15,42,4,0.357,0.395,9,0.6,6,1627748,Thon Maker,50,103,14,0.485,0.562,15,0.3,35,MIL,1610612749,13
420,7.2,9.0,7.5,96,201,70,0.478,0.733,16,0.167,79,40,25,1003.0,21,82,8,0.256,0.284,12,0.571,9,204025,Tim Frazier,117,283,78,0.413,0.571,28,0.239,88,NOP,1610612740,15
421,8.2,13.2,8.9,117,210,52,0.557,0.741,27,0.231,90,53,23,1335.0,18,38,6,0.474,0.563,8,0.444,10,203501,Tim Hardaway Jr.,135,248,58,0.544,0.711,35,0.259,100,ATL,1610612737,30
422,3.9,4.3,4.1,4,6,1,0.667,0.8,2,0.5,2,13,9,44.0,2,3,0,0.667,0.667,1,0.5,1,1627817,Tim Quarterman,6,9,1,0.667,0.75,3,0.5,3,POR,1610612757,4
423,5.0,4.4,4.7,157,291,76,0.54,0.73,39,0.248,119,53,37,1089.0,103,266,32,0.387,0.44,83,0.806,21,202389,Timofey Mozgov,260,557,108,0.467,0.579,122,0.469,140,LAL,1610612747,16
424,4.8,7.5,5.3,51,105,29,0.486,0.671,13,0.255,37,42,26,489.0,10,34,4,0.294,0.333,6,0.6,4,1627789,Timothe Luwawu-Cabarrot,61,139,33,0.439,0.575,19,0.311,41,PHI,1610612755,16
425,5.8,9.8,6.2,257,443,119,0.58,0.793,49,0.191,208,56,29,1767.0,30,82,15,0.366,0.448,19,0.633,10,202699,Tobias Harris,287,525,134,0.547,0.734,68,0.237,218,DET,1610612765,27
426,8.4,7.0,7.9,44,102,33,0.431,0.638,7,0.159,37,38,14,543.0,21,58,10,0.362,0.438,10,0.476,11,203107,Tomas Satoransky,65,160,43,0.406,0.556,17,0.262,48,WAS,1610612764,24
427,8.8,10.9,9.1,35,52,12,0.673,0.875,7,0.2,28,14,3,241.0,5,9,1,0.556,0.625,3,0.6,2,201962,Toney Douglas,40,61,13,0.656,0.833,10,0.25,30,MEM,1610612763,11
428,7.1,5.5,6.4,159,265,61,0.6,0.779,27,0.17,133,48,21,1347.0,114,282,24,0.404,0.442,84,0.737,30,2754,Tony Allen,273,547,85,0.499,0.591,111,0.407,163,MEM,1610612763,27
429,10.8,18.1,11.6,71,130,33,0.546,0.732,6,0.085,64,42,10,1090.0,8,33,4,0.242,0.276,2,0.25,6,2225,Tony Parker,79,163,37,0.485,0.627,8,0.101,70,SAS,1610612759,32
430,8.3,17.7,9.1,162,269,46,0.602,0.726,27,0.167,134,52,29,1492.0,15,29,5,0.517,0.625,5,0.333,10,203503,Tony Snell,177,298,51,0.594,0.717,32,0.181,144,MIL,1610612749,23
431,5.9,5.8,5.9,10,17,3,0.588,0.714,1,0.1,9,17,10,91.0,2,8,1,0.25,0.286,2,1.0,0,1626203,Treveon Graham,12,25,4,0.48,0.571,3,0.25,9,CHA,1610612766,7
432,5.9,13.8,6.9,280,424,97,0.66,0.856,52,0.186,229,57,17,1978.0,39,78,12,0.5,0.591,16,0.41,23,2772,Trevor Ariza,319,502,109,0.635,0.812,68,0.213,252,HOU,1610612745,40
433,4.4,5.8,4.8,294,473,85,0.622,0.758,58,0.197,238,46,39,1207.0,97,231,14,0.42,0.447,69,0.711,30,202344,Trevor Booker,391,704,99,0.555,0.646,127,0.325,268,BKN,1610612751,7
434,9.4,13.0,10.0,37,82,24,0.451,0.638,7,0.189,31,50,18,637.0,7,25,5,0.28,0.35,1,0.143,6,203504,Trey Burke,44,107,29,0.411,0.564,8,0.182,37,WAS,1610612764,32
435,5.1,5.2,5.1,163,304,93,0.536,0.773,30,0.184,133,56,21,1014.0,42,99,10,0.424,0.472,29,0.69,13,1626168,Trey Lyles,205,403,103,0.509,0.683,59,0.288,146,UTA,1610612762,35
436,5.4,4.5,5.1,311,576,146,0.54,0.723,70,0.225,241,53,16,1590.0,195,461,32,0.423,0.455,147,0.754,51,202684,Tristan Thompson,506,1037,178,0.488,0.589,217,0.429,292,CLE,1610612739,37
437,6.9,10.2,7.6,44,103,37,0.427,0.667,13,0.295,31,42,18,736.0,14,34,5,0.412,0.483,8,0.571,5,203584,Troy Daniels,58,137,42,0.423,0.611,21,0.362,36,MEM,1610612763,24
438,5.9,7.5,6.1,38,58,10,0.655,0.792,7,0.184,31,23,8,412.0,6,16,3,0.375,0.462,3,0.5,3,1627786,Troy Williams,44,74,13,0.595,0.721,10,0.227,34,MEM,1610612763,15
439,10.3,11.7,10.6,101,158,34,0.639,0.815,10,0.099,92,51,31,1253.0,33,62,7,0.532,0.6,17,0.515,16,201951,Ty Lawson,134,220,41,0.609,0.749,27,0.201,108,SAC,1610612758,20
440,7.2,9.7,7.7,14,32,8,0.438,0.583,3,0.214,11,30,8,189.0,3,11,5,0.273,0.5,0,0.0,3,203898,Tyler Ennis,17,43,13,0.395,0.567,3,0.176,14,HOU,1610612745,22
441,7.7,11.0,8.2,175,320,93,0.547,0.771,32,0.183,141,49,29,1506.0,34,110,19,0.309,0.374,16,0.471,19,204020,Tyler Johnson,209,430,112,0.486,0.657,48,0.23,160,MIA,1610612748,20
442,12.2,19.1,14.5,16,33,7,0.485,0.615,0,0.0,16,34,26,304.0,8,16,3,0.5,0.615,1,0.125,7,1627755,Tyler Ulis,24,49,10,0.49,0.615,1,0.042,23,PHX,1610612756,8
443,5.3,5.2,5.3,57,107,22,0.533,0.671,23,0.404,34,33,13,361.0,31,77,5,0.403,0.431,20,0.645,11,203092,Tyler Zeller,88,184,27,0.478,0.561,43,0.489,45,BOS,1610612738,20
444,6.7,8.0,6.8,80,129,28,0.62,0.792,17,0.213,63,26,13,474.0,6,25,2,0.24,0.261,3,0.5,3,201936,Tyreke Evans,86,154,30,0.558,0.694,20,0.233,66,NOP,1610612740,13
445,4.0,4.8,4.2,351,543,90,0.646,0.775,85,0.242,264,44,31,1193.0,135,289,23,0.467,0.508,105,0.778,32,2199,Tyson Chandler,486,832,113,0.584,0.676,190,0.391,296,PHX,1610612756,13
446,11.1,16.1,12.2,25,45,12,0.556,0.758,1,0.04,24,35,21,398.0,7,11,2,0.636,0.778,1,0.143,6,1626145,Tyus Jones,32,56,14,0.571,0.762,2,0.063,30,MIN,1610612750,14
447,4.7,8.5,5.5,27,56,16,0.482,0.675,10,0.37,17,15,10,129.0,8,21,1,0.381,0.4,5,0.625,3,2617,Udonis Haslem,35,77,17,0.455,0.583,15,0.429,20,MIA,1610612748,5
448,6.9,15.8,8.1,179,319,84,0.561,0.762,40,0.223,139,47,20,1586.0,28,68,9,0.412,0.475,10,0.357,18,203506,Victor Oladipo,207,387,93,0.535,0.704,50,0.242,157,OKC,1610612760,27
449,6.7,9.9,7.2,130,233,67,0.558,0.783,20,0.154,110,49,22,1180.0,24,52,6,0.462,0.522,15,0.625,9,1713,Vince Carter,154,285,73,0.54,0.726,35,0.227,119,MEM,1610612763,27
450,9.6,12.9,10.2,25,45,18,0.556,0.926,5,0.2,20,23,8,295.0,6,18,0,0.333,0.333,3,0.5,3,1627735,Wade Baldwin IV,31,63,18,0.492,0.689,8,0.258,23,MEM,1610612763,15
451,8.0,15.8,9.1,63,125,29,0.504,0.656,4,0.063,61,37,18,970.0,11,25,2,0.44,0.478,5,0.455,6,201961,Wayne Ellington,74,150,31,0.493,0.622,9,0.122,67,MIA,1610612748,19
452,5.3,13.0,6.5,131,209,41,0.627,0.78,27,0.206,103,48,20,633.0,24,45,7,0.533,0.632,9,0.375,15,202325,Wesley Johnson,155,254,48,0.61,0.752,36,0.232,118,LAC,1610612746,28
453,7.3,15.2,7.9,179,310,62,0.577,0.722,28,0.156,151,52,32,1836.0,12,30,3,0.4,0.444,5,0.417,9,202083,Wesley Matthews,191,340,65,0.562,0.695,33,0.173,160,DAL,1610612742,20
454,6.0,10.4,7.0,147,265,77,0.555,0.782,16,0.109,130,41,21,1198.0,45,102,12,0.441,0.5,29,0.644,17,203115,Will Barton,192,367,89,0.523,0.691,45,0.234,147,DEN,1610612743,20
455,5.1,7.1,5.8,88,173,35,0.509,0.638,23,0.261,66,50,29,649.0,47,102,3,0.461,0.475,34,0.723,13,1626161,Willie Cauley-Stein,135,275,38,0.491,0.57,57,0.422,79,SAC,1610612758,21
456,4.5,3.6,4.1,142,235,45,0.604,0.747,39,0.275,102,48,24,702.0,87,175,10,0.497,0.527,70,0.805,17,203186,Willie Reed,229,410,55,0.559,0.645,109,0.476,119,MIA,1610612748,24
457,3.8,4.1,3.9,195,335,67,0.582,0.728,56,0.287,140,49,29,769.0,95,209,22,0.455,0.508,71,0.747,22,1626195,Willy Hernangomez,290,544,89,0.533,0.637,127,0.438,162,NYK,1610612752,20
458,5.3,7.0,5.7,250,390,81,0.641,0.809,50,0.2,198,49,27,1512.0,77,140,16,0.55,0.621,56,0.727,21,201163,Wilson Chandler,327,530,97,0.617,0.755,106,0.324,219,DEN,1610612743,22
459,9.8,13.3,10.4,34,62,12,0.548,0.68,6,0.176,28,20,13,482.0,8,17,2,0.471,0.533,1,0.125,7,1627812,Yogi Ferrell,42,79,14,0.532,0.646,7,0.167,35,DAL,1610612742,7
460,7.8,17.5,9.0,142,237,63,0.599,0.816,15,0.106,126,47,31,1749.0,19,41,9,0.463,0.594,8,0.421,11,203897,Zach LaVine,161,278,72,0.579,0.782,23,0.143,137,MIN,1610612750,16
461,4.3,4.6,4.4,281,418,76,0.672,0.822,68,0.242,212,49,20,1187.0,123,240,22,0.513,0.564,87,0.707,36,2216,Zach Randolph,404,658,98,0.614,0.721,155,0.384,248,MEM,1610612763,29
462,4.5,5.4,4.8,168,290,72,0.579,0.771,57,0.339,108,43,6,803.0,88,194,14,0.454,0.489,61,0.693,27,2585,Zaza Pachulia,256,484,86,0.529,0.643,118,0.461,135,GSW,1610612744,37
